BACKGROUND: BAC00Escherichia_coli ( BAC00E0_coli ) strains, expressing S-fimbriae, belong to the most common gram-negative pathogens that cause DIS00sepsis and DIS00meningitis in neonates.	pathogen, cause
In addition, among the extracellular products, those which have cytotoxic activity to Vero cells may contribute to the lethality in DIS00sepsis caused by BAC00S0_aureus in this murine model.	cause
BAC00Streptococcus_pneumoniae , the pneumococcus, is the most common cause of DIS00sepsis and DIS00meningitis .	cause
Cyclophosphamide was then administered to induce DIS00leukopenia and translocation of the BAC00P0_aeruginosa that had colonized the gastrointestinal tract, thereby producing gut-derived generalized DIS00sepsis .	None
Our results indicate that antiflagellar human monoclonal antibody SC-1225 protects mice against gut-derived DIS00sepsis caused by BAC00P0_aeruginosa and suggest that such an effect is due to its opsonophagocytic activity and the reduced motility of the translocated bacteria once the bacteria move from the intestine into the bloodstream.	cause
The study shows a high prevalence of neonatal bacterial DIS00sepsis at the centre and the emerging role of BAC00Listeria_monocytogenes in the aetiology of DIS00neonatal_sepsis .	None
The effect of passive immunotherapy with antisera against heat-killed BAC00Pseudomonas_aeruginosa and three of its exo-enzymes (elastase, alkaline protease and exotoxin A) in gut-derived DIS00P0_aeruginosa_sepsis was evaluated.	None
Cyclophosphamide was then administered to induce translocation of BAC00P0_aeruginosa that had colonised the gastrointestinal tract so that gut-derived DIS00septicaemia was produced.	None
These results indicate that passive immunisation with antiserum against heat-killed bacteria and exotoxin A, but not with antiserum against either elastase or alkaline protease, protects mice against gut-derived DIS00sepsis caused by BAC00P0_aeruginosa .	cause
Of the organisms encountered, BAC00Staphylococcus_aureus was the most frequently occurring organism (39%), followed by coliform bacilli (24%), which was the most prevalent organism (44%) in post-operative DIS00sepsis .	None
BACKGROUND: To evaluate clinical and microbiological characteristics of DIS00sepsis due to BAC00Corynebacterium_amycolatum , because few cases have been reported in human DIS00infections by this bacteria.	due to
METHODS: We report two cases of DIS00sepsis due to BAC00Corynebacterium_amycolatum , the patients were diagnosed as having DIS00leukaemia .	due to
To evaluate the protective effect of trovafloxacin, ciprofloxacin and ampicillin against penicillin-susceptible, -intermediate and -resistant strains of BAC00Streptococcus_pneumoniae , an intraperitoneal, immunocompetent mouse model of DIS00sepsis was used.	None
Norepinephrine stimulates growth of BAC00Escherichia_coli , BAC00Yersinia_enterocolitica , and BAC00Pseudomonas_aeruginosa in serum-supplemented media, and in vivo increases in norepinephrine may be important in the pathogenesis of DIS00sepsis by gram-negative bacteria.	None
The significant resistance to antibiotics was present in 47% of Gram-negative DIS00sepsis (causative microorganisms were BAC00Pseudomonas_aeruginosa and BAC00Acinetobacter species) and in 18% of Gram-positive DIS00sepsis (susceptibility to imipenem only in Gram-negative DIS00sepsis and susceptibility to vankomycin in Gram-positive DIS00sepsis ).	causative, microorganism
BACKGROUND: BAC00Klebsiella_pneumoniae is a major cause of DIS00neonatal_sepsis_and_nosocomial_infections in Mexico.	cause
BAC00Yersinia_enterocolitica accounts for 50% of the clinical DIS00sepsis episodes caused by the transfusion of contaminated red blood cells.	account
Counts of inoculated BAC00E0_coli and translocated bacteria in different locations, gut morphology and haematological values were evaluated at different stages of DIS00sepsis .	None
In early DIS00sepsis , translocation was associated with high BAC00E0_coli counts in blood, yet in late DIS00sepsis the opposite correlation was present.	associate, opposite, correlation
CONCLUSIONS: BAC00P0_aeruginosa may act as a pathogen in the gastrointestinal tract, resulting in altered epithelial barrier function and DIS00death in a susceptible host.	result
One patient had catheter-related DIS00sepsis with BAC00Staphylococcus_aureus .	with
Also, whereas DIS00NE0deficient mice had impaired survival in response to DIS00E0_coli_sepsis , as compared to wild-type mice, the presence or absence of NE had no influence on survival in response to DIS00sepsis that had been induced with OmpA-deficient BAC00E0_coli .	induce
The immunotherapies were developed in the late 1960s and put into widespread use in the Soviet Union for the prophylaxis and treatment of DIS00sepsis , DIS00pneumonia , and other conditions caused by an DIS00epidemic of antibiotic-resistant BAC00Staphylococcus_aureus .	cause
The common pathogens were BAC00Escherichia_coli (57%), BAC00Enterococcus (27%), DIS00Klebsiella_pneumonia (18%), BAC00Morganella_morganii (7.6%), BAC00Pseudomonas_aeruginosa (4.1%) and BAC00Salmonella (0.7%).	None
Coagulase negative BAC00Staphylococcus (CONS) (50%) was the most common infecting organism causing late onset DIS00sepsis (LOS) and BAC00Escherichia_coli (29%) the most common causing early onset DIS00sepsis (EOS).	cause
The primary DIS00disease was DIS00sepsis in these three patients; BAC00S0_aureus was cultured from blood in two patients and Gram-positive cocci was observed following examination of the joint fluid in the other patient.	None
By using a similar experimental setup, severe DIS00hyperdynamic_sepsis was induced (n = 15) by intravenous infusion of live BAC00Escherichia_coli (2 x 10(9) colony-forming units/kg) over 2 hrs, followed by antibiotic therapy (gentamicin 4 mg/kg twice a day).	induce
MEASUREMENTS AND MAIN RESULTS: Plasma PCT at baseline was barely detectable, but levels increased significantly (p < .05) to 2+/-1.8 pg/mL 2 hrs after the start of reperfusion in the shock group, and to 987+/-230 pg/mL at 4 hrs after BAC00E0_coli in the DIS00sepsis group.	in
PCT levels were approximately three times higher in the DIS00sepsis group than in the shock group, corresponding to endotoxin levels (at the end of DIS00hemorrhage , 286+/-144 pg/mL vs. 3576+/-979 pg/mL at the end of BAC00E0_coli infusion; p = .003).	None
OBJECTIVE: To determine whether low "stretch" mechanical ventilation protects animals from clinical DIS00sepsis after direct DIS00acute_lung_injury with BAC00Pseudomonas_aeruginosa as compared with high "stretch" ventilation.	with
OBJECTIVE: Report of 8 cases of disseminated DIS00infection with BAC00V0_vulnificus causing fulminant DIS00sepsis . DESIGN: Series of cases.	cause
Notably, blockade of TREM-1 protects mice against DIS00LPS -induced DIS00shock , as well as microbial DIS00sepsis caused by live BAC00Escherichia_coli or caecal ligation and puncture.	cause
BAC00Streptococcus_agalactiae (group B streptococcus, DIS00GBS ) is the major pathogen of DIS00neonatal_sepsis .	pathogen
To determine the role of endogenous IL-10 in local antibacterial host defense and in the development of a DIS00systemic_inflammatory_response_syndrome during DIS00abdominal_sepsis , IL-10 gene-deficient (IL-10(-/-)) and wild-type (IL-10(+/+)) mice received an i.p. injection with BAC00Escherichia_coli .	None
The results suggest that activation of the contact system at the surface of BAC00S0_aureus and the subsequent release of bradykinin could contribute to the DIS00hypovolemic_hypotension seen in patients with severe DIS00S0_aureus_sepsis .	contribute
Antibiotic-resistant bacteria include the enteric gram-negative bacilli, especially BAC00Escherichia_coli , BAC00Klebsiella and BAC00Enterobacter , and BAC00Haemophilus_influenzae type b, a major respiratory tract pathogen and cause of DIS00meningitis .	pathogen, cause
During the last few years, there has been an increased number of case reports claiming an association of BAC00C0_xerosis with DIS00diseases , like DIS00septicemia , DIS00endocarditis , DIS00pleuropneumonia , DIS00peritonitis , DIS00osteomyelitis , DIS00septic_arthritis , DIS00mediastinitis , DIS00meningitis , DIS00ventriculitis specially in immunocompromised patients or surgical patients.	associate
We report a case of DIS00sepsis due to BAC00C0_xerosis in a newborn without evident DIS00immunodeficiency .	due to
Severe DIS00hyperdynamic_sepsis was induced in baboons (n = 14) by i.v. infusion of live BAC00E0_coli (approximately 2 x 10(9) colony-forming units/kg) over 2 h. Animals were pretreated 2 h before BAC00E0_coli either with 1 mg/kg humanized anti-TNF antibody (CDP571) or placebo (Ringer solution).	induce
To determine the relative contribution of lipopolysaccharide (LPS) and non-LPS components of BAC00Neisseria_meningitidis to the pathogenesis of DIS00meningococcal_sepsis , this study quantitatively compared cytokine induction by isolated LPS, wild-type serogroup B meningococci (strain H44/76), and DIS00LPS0deficient mutant meningococci (strain H44/76[pLAK33]).	pathogenesis
The principal conclusion is that non-LPS parts of BAC00N0_meningitidis may play a role in the pathogenesis of DIS00meningococcal_sepsis by inducing substantial TNF-alpha, IL-1beta, and IFN-gamma production.	pathogenesis
Plasma was collected from thermally injured rats with BAC00E0_coli O18 DIS00sepsis and filtered. DIS00LPS was affinity-purified from plasma filtrates using monoclonal antibody specific for the O-polysaccharide side chain of BAC00E0_coli O18 DIS00LPS .	None
DIS00Blood0brain_barrier (BBB) permeability during DIS00sepsis with BAC00Escherichia_coli or BAC00Streptococcus_pneumoniae was examined in a mouse model and measured by a circulating beta-galactosidase tracer.	with
A model of ALI was used in which adult baboons were primed with killed BAC00Escherichia_coli (1 x 10(9) CFU/kg), and DIS00bacteremic_sepsis was induced 12 h later by infusion of live BAC00E0_coli at 1 x 10(10) CFU/kg.	induce
Recombinant MIF was found to exacerbate lethal DIS00endotoxemia or bacterial DIS00sepsis when co-injected with DIS00LPS or BAC00Escherichia_coli in mice.	co-injected
BAC00Streptococcus_pyogenes causes severe DIS00invasive_diseases in humans, including DIS00necrotizing_fasciitis , DIS00sepsis , and DIS00streptococcal_toxic_shock_syndrome ( DIS00STSS ).	cause
In addition, a human clinical isolate of BAC00P0_aeruginosa , strain PA14, also causes DIS00disease in a variety of nonvertebrate hosts, including plants, Caenorhabditis elegans, and the greater wax moth, Galleria mellonella.	cause
Mutation of the ybtQ homolog in BAC00P0_aeruginosa strain PA14 significantly attenuates the virulence of this strain in both G. mellonella and a burned mouse model of DIS00sepsis to levels comparable to those seen with PAO1.	None
BAC00Streptococcus_pneumoniae is an important cause of upper and lower DIS00respiratory_tract_infections , DIS00meningitis , DIS00peritonitis , DIS00bacterial_arthritis , and DIS00sepsis .	cause
BAC00Streptococcus_pneumoniae is the commonest infecting organism, accounting for 50-90% of isolates from blood cultures in reported series; it is particularly common in children with DIS00sickle_cell_disease .	with
BAC00Streptococcus_suis capsular type 2 is an important aetiologic agent of DIS00swine_meningitis , and it has been highlighted as a cause of DIS00occupational_disease leading to DIS00meningitis and fulminant DIS00sepsis in humans.	aetiologic, agent
Mice infected with the gram-negative BAC00bacterium_Salmonella_enterica serovar Typhimurium exhibit marked genetic differences in DIS00disease manifestation, and the wild-derived strain Mus musculus molossinus MOLF/Ei is extremely susceptible to BAC00S0_enterica serovar Typhimurium.	in
IL-1R-deficient mice (IL-1R(-/-)) and their wild-type controls (IL-1R(+/+)) were i.v. inoculated with 1 x 10(7) or 10(6) BAC00Staphylococcus_aureus per mouse to mimic bacterial DIS00sepsis and DIS00septic_arthritis .	None
BAC00Staphylococcus_aureus is one of the most significant pathogens in human DIS00sepsis and DIS00endocarditis .	pathogen
BAC00S0_aureus can initiate DIS00blood_coagulation , leading to the formation of microthrombi and DIS00multiorgan_dysfunction in DIS00sepsis , whereas in DIS00endocarditis the BAC00bacterium induces fibrin clots on the inner surface of the heart, so-called endocardial vegetations.	initiate
DIS00Sepsis induced by BAC00S0_aureus was used to investigate whether neutrophil DIS00migration_failure to infectious focus correlates with lethality in Gram-positive bacteria-induced DIS00sepsis in mice.	induced by
Early DIS00sepsis occurs during the first week and presents in the form of frank clinical features ( DIS00pain , DIS00erythema , DIS00penile_discharge ); highly virulent bacteria are isolated, such as BAC00Staphylococcus_aureus .	isolate
Late DIS00sepsis occurs after an interval of several weeks to several months with less specific clinical features; BAC00Staphylococcus_epidermidis is isolated in more than 50% of cases.	isolate
CONCLUSION: Supplementary BAC00L0_plantarum 299 was effective in reducing DIS00pancreatic_sepsis and the number of surgical interventions.	effective in reduce
For DIS00gallstone_diseases , the most common organisms cultured were Gram negative bacteria (74%), in which BAC00Escherichia_coli (36%) and BAC00Klebsiella (15%) were most commonly found, followed by Gram positive (15%) bacteria such as BAC00Enterococcus (6%), Staphylcoccus (3%), BAC00Streptococcus (2%).	None
--In one boy OIPD was discovered at the age of 7 weeks following treatment first for neonatal DIS00sepsis and then for DIS00urinary_infection , both caused by the same phage type of BAC00Staphylococcus_aureus .	cause
RWJ-54428 was effective in vivo against methicillin-susceptible and -resistant BAC00S0_aureus in a mouse model of DIS00sepsis , with 50% effective doses being similar to those of vancomycin.	None
In a mouse model of DIS00pneumonia due to a penicillin-susceptible strain of BAC00Streptococcus_pneumoniae , RWJ-54428 displayed efficacy and potency superior to those of penicillin G and cefotaxime.	due to
OBJECTIVE: To investigate the protective effect and its underlying mechanism of 2,4-diamino-6-hydroxy-pyrimidine (DAHP), an inhibitor of DIS00GTP0cyclohydrolase_I (GTP-CHI), on postburn BAC00Staphylococcus_aureus ( BAC00S0_aureus ) DIS00sepsis in rats.	None
To further assess the role of BAK in DIS00sepsis in DIS00acute_renal_failure , dogs were nephrectomized and 48 h later administered intraperitoneally with 30 x 10(10) bacteria/kg of BAC00E0_coli .	None
BACKGROUND: BAC00Yersinia_enterocolitica , BAC00Pseudomonas_fluorescens , and BAC00P0_putida are responsible for a significant amount of the bacterial DIS00sepsis cases attributed to RBC transfusions.	responsible
BAC00Pseudomonas_aeruginosa is a pathogen that frequently causes DIS00acute_lung_injury , DIS00bacteremia and DIS00sepsis in critically ill patients.	cause
One week later, he was admitted to our hospital and was subsequently diagnosed with DIS00sepsis associated with four species of bacteria ( BAC00Streptococcus_constellatus , BAC00Fusobacterium_mortiferum , BAC00Bacteroides_thetaiotaomicron , and non-spore-forming anaerobic gram-positive bacillus).	associate
The two leading causes of DIS00bacterial_pneumonia in childhood are BAC00Streptococcus_pneumoniae (SP) and BAC00Haemophilus_influenzae type b (Hib).	cause
Extraintestinal BAC00Escherichia_coli strains cause DIS00meningitis , DIS00sepsis , DIS00urinary_tract_infection , and other DIS00infections outside the bowel.	cause
METHODS: Patients with DIS00acute_pancreatitis , arriving within 48 hours after onset of DIS00disease showing typical clinical picture and laboratory signs of DIS00pancreatitis (plasma amylase > 200 U/l, CRP > 150 mg/l and an Imrie-score = or > 3) were randomised into two groups During the first week the treatment group received a freeze-dried preparation containing 10(9) live BAC00Lactobacillus_plantarum 299 together with an oat fibre substrate.	None
CONCLUSIONS: Supplementing BAC00Lactobacillus_plantarum 299 is an effective tool to prevent DIS00pancreatic_sepsis , to reduce the number of operations and length of stay.	prevent
INTERVENTIONS: Mice were subjected to intratracheal injection of BAC00Pseudomonas_aeruginosa and killed between 1.5 and 24 hrs after induction of pneumonia-induced DIS00sepsis to assess for gut epithelial proliferation and cell division and for apoptosis.	None
In contrast, cells in M-phase remained constant for the first 12 hrs after the onset of DIS00sepsis , but increased nearly 50% at 24 hrs after instillation of BAC00P0_aeruginosa (p <.005).	None
CONCLUSION: Antibody to TNF improved host defense and survival rates with both lethal BAC00E0_coli and DIS00S0_aureus_pneumonia , but protection was greater with BAC00E0_coli , where TNF concentrations were higher than with BAC00S0_aureus .	None
RESULTS: The counts of BAC00E0_coli were the highest in the organs and blood 6 h after the onset of DIS00sepsis , being in correlation with the highest counts of apoptotic cells in the liver and the falling counts of activated macrophages.	highest
A low incidence of nasal carriage of BAC00S0_aureus isolates correlated with low incidence of wound DIS00sepsis .	correlate
The human-specific bacterial pathogen BAC00Neisseria_meningitidis is a major cause of DIS00sepsis and/or DIS00meningitis .	cause
In a subgroup of patients with severe DIS00sepsis or DIS00septic_shock , caused by other bacteria than BAC00Neisseria_meningitidis , the M/F-ratio was 2.1 (1.2;3.6) (Chi2= 4.9; P<0.05), while in patients with DIS00meningococcal_sepsis (n=20) the M/F-ratio was 1.0 (0.4;2.3).	cause
Out of 233 positive blood cultures BAC00Escherichia_coli was found to be commonest (47.8%, n=111, p <0.05) both in early onset (47.8%, n=68, p <0.05) and late onset DIS00sepsis (47.3%, n=43, p<0.05).	in
BAC00Streptococcus_agalactiae is the leading cause of bacterial DIS00sepsis and DIS00meningitis in neonates and also the causative agent of different serious DIS00infections in immunocompromised adults.	cause
The wide range of DIS00diseases that are caused by BAC00S0_agalactiae suggests regulatory mechanisms that control the formation of specific virulence factors in these bacteria.	cause
BAC00Staphylococcus_epidermidis is the most frequent cause of nosocomial DIS00sepsis and catheter-related DIS00infections , in which biofilm formation is considered to be the main virulence mechanism.	cause
S-fimbriae are a common property of BAC00E0_coli strains causing DIS00sepsis and DIS00meningitis in neonates.	cause
S fimbriae are a common feature of BAC00E0_coli strains causing DIS00sepsis and DIS00meningitis in newborns and are bound to epithelia via sialyl-(alpha-2-3)galactoside structures.	cause
BAC00Streptococcus_suis is a common cause of DIS00sepsis , DIS00meningitis , and other serious DIS00infections in young piglets and also causes DIS00meningitis in humans.	cause
An experimental model for DIS00intra0abdominal_sepsis was created with implantation of gelatin capsules, containing 3 x 10(8) cfu BAC00E0_coli strain no. 2554, in the peritoneal cavity of 20 rats (10 animals received and 10 did not receive antibiotic therapy with ceftriaxone) in order to verify the role of the primary site of DIS00infection in the pathogenesis of DIS00pneumonia .	None
Virulence factors (serogroup, DIS00haemolysis , haemagglutination, antigens K1, K5, colicinogenicity) and their association with DIS00diseases of 3334 BAC00Escherichia_coli strains isolated from different clinical specimens between 1979-1990 were analysed.	None
RESULTS: Eleven of the 20 patients had bacteriologically documented DIS00infections : four with DIS00meningitis and two with DIS00bacteremia caused by BAC00Neisseria_meningitidis , three with DIS00meningitis caused by BAC00Haemophilus_influenzae type b, and one each with DIS00meningitis_and_bacteremia caused by BAC00Streptococcus_pneumoniae .	cause
BAC00Streptococcus_pneumoniae is a leading cause of gram-positive DIS00sepsis , and lipoteichoic acid (LTA) may be important in causing gram-positive bacterial DIS00septic_shock .	cause
We investigated plasma proinflammatory cytokine profiles in patients with DIS00sepsis due to gram-positive and gram-negative bacteria and studied the cytokine production and differential gene regulation of leukocytes stimulated ex vivo with BAC00Escherichia_coli lipopolysaccharide or heat-killed BAC00Staphylococcus_aureus .	None
Sixteen years after transplant, she presented with Gram-negative DIS00sepsis with BAC00Proteus_mirabilis and acute DIS00anuric_renal_failure in the allograft.	with
RESULTS: The etiological agents more frequently found are BAC00Streptococcus_pneumoniae , DIS00Haemophilus_influenza_and_type_B , and BAC00Neisseria_meningitidis .	None
BAC00Listeria_monocytogenes is the causative agent of DIS00infections_like_sepsis and DIS00meningitis , especially in immunocompromised hosts.	causative agent
Furthermore, a single infusion of MAb 12-9 was protective against an intravenous challenge with a methicillin-resistant strain of BAC00S0_aureus in a murine DIS00sepsis model (P < 0.0001).	in
BACKGROUND: BAC00Staphylococcus_aureus is one of the most common bacteria in human DIS00sepsis , a condition in which the activation of DIS00blood_coagulation plays a critical pathophysiological role.	bacteria
These signals may explain the potent effects of BAC00N0_meningitidis on CD62E expression on vascular endothelium and provide a basis for the complex DIS00endothelial_dysregulation seen in DIS00meningococcal_sepsis .	None
BAC00Escherichia_coli is a major cause of DIS00neonatal_bacterial_sepsis and DIS00meningitis .	cause
Furthermore, we determined that tissue macrophages and dendritic cells within the liver and spleen are the major cellular targets of BAC00E0_coli_K1 and that TraJ significantly contributes to the predominantly intracellular nature of BAC00E0_coli_K1 within these professional phagocytes exclusively during the early stages of DIS00systemic_disease .	None
These data indicate that, contrary to earlier indications, BAC00E0_coli_K1 resides within professional phagocytes, and this is essential for the efficient progression of DIS00systemic_disease .	None
DIS00Zwitterionic_polysaccharides (Zps) from pathogenic bacteria, such as BAC00Bacteroides_fragilis , are virulence factors responsible for DIS00abscess formation associated with DIS00intra0abdominal_sepsis .	pathogenic bacteria
By contrast, prior experience with BAC00E0_coli abscess production resulted in 25% failure rate of abscess production or DIS00death from DIS00sepsis .	result
Two putative types of siderophore synthesis operons, named BAC00Bacillus_anthracis catechol, bac (anthrabactin), and DIS00anthrax siderophore biosynthesis, asb (anthrachelin), were identified.	None
Successful establishment of DIS00sepsis by entrapping a dose of 150 colony forming units of BAC00Klebsiella_pneumoniae in a fibrin clot following implantation into the peritoneal cavity of mice is reported.	establishment
Gram-negative bacteria were most commonly found as a cause of early onset DIS00sepsis , with BAC00Enterobacter_aerogenes as the most common agent.	agent
BAC00Enterobacter_aerogenes is an important pathogen in the etiology of early onset DIS00sepsis in the newborn at the State University Hospital of Haiti, while Group B BAC00Streptococcus is the leading cause of DIS00meningitis in that age group.	pathogen
BACKGROUND: The relative contributions of the cytotoxic phenotype of BAC00P0_aeruginosa expressing DIS00type_III_secretory_toxins and an immunocompromised condition lacking normal Toll-like receptor 4 (TLR4) signaling in the pathogenesis of DIS00acute_lung_injury and DIS00sepsis were evaluated in a mouse model for DIS00Pseudomonas_aeruginosa_pneumonia .	expressing
By using lipopolysaccharide-resistant C3H/HeJ mice missing normal TLR4 signaling due to a mutation on the tlr4 gene, we evaluated how TLR4 signaling modulates the DIS00pneumonia caused by cytotoxic BAC00P0_aeruginosa expressing type III secretory toxins.	cause
RESULTS: Development of DIS00acute_lung_injury and DIS00sepsis was observed in all mouse strains when the cytotoxic BAC00P0_aeruginosa strain but not the non-cytotoxic strain was instilled in the airspaces of the mice.	observe
CONCLUSION: The cytotoxic phenotype of BAC00P0_aeruginosa is the critical factor causing DIS00acute_lung_injury and DIS00sepsis in infected hosts.	causing
Our group found that a whole bacterial vaccine made from the BAC00Escherichia_coli O111:B4, J5 (Rc chemotype) mutant induced protective antibodies when given passively as treatment for DIS00sepsis in a DIS00neutropenic rat model.	induce, protective antibody
BAC00Streptococcus_pneumoniae , BAC00Streptococcus_pyogenes , and staphylococci, organisms that cause respiratory and DIS00cutaneous_infections , and members of the BAC00Enterobacteriaceae and BAC00Pseudomonas families, organisms that cause DIS00diarrhea , DIS00urinary_infection , and DIS00sepsis , are now resistant to virtually all of the older antibiotics.	cause
A unique case of community acquired methicillin resistant BAC00Staphylococcus_aureus (MRSA) DIS00sepsis , with endocardial and cerebral metastatic seeding, caused by a strain representative of the Italian clone, is described.	None
Whole blood anticoagulated with lepirudin was stimulated with wild-type BAC00Neisseria_meningitidis_H44076 ( DIS00LPS +), DIS00LPS -deficient BAC00N0_meningitidis H44/76lpxA ( DIS00LPS -), or purified DIS00meningococcal_LPS (NmLPS) at concentrations that were relevant to DIS00meningococcal_sepsis .	None
BAC00Streptococcus_agalactiae is a major cause of bacterial DIS00sepsis and DIS00meningitis in human newborns.	cause
MICs of MEPM against 6 clinically isolated bacteria (B. catarrhalis 2, BAC00S0_pneumoniae 3 and BAC00S0_aureus 1) from children with DIS00bacterial_infections were examined.	isolate
We describe such a patient who contracted DIS00sepsis from BAC00Pseudomonas_aeruginosa .	from
Burn DIS00sepsis during shock stage occurred in 4 cases (9.09%), in which one was caused by BAC00Pseudomonas_aeruginosa and other three possibly by BAC00Escherichia_coli , BAC00Streptococcus faecalis and BAC00Bacillus gasoformans.	cause
BAC00Streptococcus_agalactiae (Group B DIS00Streptococcus0_GBS ) is the major causative agent of DIS00neonatal_sepsis .	 causative agent
Log reduction of Gram-positive bacteria for BAC00Staphylococcus_epidermidis was > 6.6; for BAC00Staphylococcus_aureus , 6.6; for BAC00Streptococcus_pyogenes , > 6.8; for BAC00Listeria_monocytogenes , > 6.3; for BAC00Corynebacterium_minutissimum , > 6.3; for BAC00Bacillus_cereus (vegetative), > 5.5; for BAC00Lactobacillus sp., > 6.4; for BAC00Bifidobacterium_adolescentis , > 6.0; for BAC00Propionibacterium_acnes , > 6.2; and for BAC00Clostridium_perfringens , > 6.5. Log reduction of Gram-negative bacteria for BAC00Escherichia_coli was > 6.4; for BAC00Serratia_marcescens , > 6.7; for BAC00Klebsiella_pneumoniae , > 5.6; for BAC00Pseudomonas_aeruginosa , 4.5; for DIS00Salmonella_choleraesuis , > 6.2; for BAC00Yersinia_enterocolitica , > 5.9; and for BAC00Enterobacter_cloacae , 5.9.	None
CONCLUSION: In contrast to DIS00extravascular_infection , DIS00sepsis with intravascular BAC00E0_coli in canines and BAC00S0_aureus in rats may not provide a compartmentalized nidus of bacteria on which G-CSF-stimulated neutrophils can exert a beneficial antimicrobial effect.	with
Moreover, review of photographs on file at the Centers for DIS00Disease Control revealed this dramatic color change in 2 units of blood that caused transfusion-transmitted DIS00sepsis ( BAC00Enterobacter agglomerans and an unidentified gram-negative bacillus, not BAC00Yersinia sp.), which demonstrated that the color change was not limited to BAC00Y0_enterocolitica .	None
BAC00Vibrio_vulnificus causes severe DIS00sepsis in humans.	cause
To determine the role of IL-12 in abdominal DIS00sepsis , p35 gene-deficient (IL-12 knockout, KO) mice and normal wild-type (WT) mice were injected intraperitoneally with BAC00Escherichia_coli .	None
Gram-negative bacteria were the cause of DIS00sepsis in 57% of patients ( BAC00Pseudomonas0200 , BAC00Klebsiella0200 , BAC00E0_coli08 .5%, BAC00Acinetobacter08 .5%), gram-positive in 43% (coagulase-negative Staphylococci--14%, BAC00Staphylococcus_epidermidis0140 , BAC00Staphylococcus_aureus090 , BAC00Streptococcus group B--3%, BAC00Listeria_monocytogenes030 ).	cause
BAC00Stenotrophomonas_maltophilia is an emerging pathogen implicated in an increasing number of severe DIS00pulmonary_infections and nosocomial DIS00sepsis .	pathogen
We also investigated the influence of the above mentioned antibiotics on the ability of BAC00S0_maltophilia culture filtrates and DIS00S0_maltophilia_LPS , extracted in our laboratory, to stimulate DIS00sepsis mediators such as DIS00tumor_necrosis factor a (TNF-a), interleukin 8 (IL-8), interleukin 10 (IL-10), Nitric Oxide (NO) and as bactericidal/permeability-increasing protein (BPI) in human whole blood.	None
We describe the first reported case of DIS00infection due to BAC00O0_anthropi in a child, that of DIS00bacteremia in a 3-year-old girl undergoing chemotherapy for DIS00retinoblastoma .	due to
BAC00Vibrio_vulnificus is an opportunistic pathogen of humans that has the capability of causing rare, yet devastating DIS00disease .	pathogen
Additionally, in otherwise healthy people, BAC00V0_vulnificus causes wound DIS00infection that can require amputation or lead to DIS00sepsis .	cause
Despite the analysis of virulence for over 20 years using a combination of animal and cell culture models, surprisingly little is known about the mechanisms by which BAC00V0_vulnificus causes DIS00disease .	cause
BAC00Salmonella_enterica serovar Choleraesuis (S. Choleraesuis), a highly invasive serovar among non-typhoidal BAC00Salmonella , usually causes DIS00sepsis or extra- DIS00intestinal_focal_infections in humans.	cause
In this study, we have determined the role of mast cells in the inflammatory response and DIS00disease induced by BAC00C0_rodentium .	induce
BACKGROUND: Despite routine bacterial screening with a bacterial culturing system (BacT/ALERT, bioMerieux) of platelet (PLT) concentrates, two cases of life-threatening DIS00sepsis attributed to transfused PLT products contaminated with BAC00Bacillus_cereus were reported to the regional hemovigilance office in the southwest region of the Netherlands.	contaminate
The importance of bacteria in DIS00sepsis0related_lung_injury was studied in rats given an intraperitoneal injection of BAC00E0_coli or in rats given the adjuvant substance alone in capsules intraperitoneally.	injection
INTERVENTIONS: DIS00Abdominal_sepsis was induced by the intraperitoneal injection of BAC00Escherichia_coli . DIS00Pancreatitis was induced by 12 hourly intraperitoneal injections of cerulein.	induce
In this study, BAC00Escherichia_coli 25922 ( BAC00E0_coli 25922) and DIS00LPS were used to induce DIS00sepsis in an animal model.	induce
BAC00Neisseria_meningitidis is a major cause of DIS00sepsis and/or DIS00meningitis .	cause
Especially in ICU patients with severe DIS00pneumonia (NP or CAP) or DIS00septicemia and risk factors like underlying DIS00diseases , antibiotic pretreatment or mechanical ventilation, agents with an appropriate spectrum encompassing BAC00Pseudomonas_aeruginosa as well as other Gram-negative bacteria like BAC00Escherichia_coli , BAC00Klebsiella spp., BAC00Enterobacter spp. and Gram-positive bacteria (e.g. BAC00Staphylococcus_aureus , pneumococci and streptococci) are recommended as treatment of choice.	agent
Unlike most other pathogens in CF, which typically remain confined to the endobronchial spaces, BAC00B0_cenocepacia can traverse airway epithelium to cause DIS00bacteremia and DIS00sepsis .	cause
Although 3OC12-HSL production by BAC00P0_aeruginosa was important for virulence in a mouse DIS00sepsis model, Pon1-knock-out mice were paradoxically protected.	important
BACKGROUND: An experimental vaccine for DIS00sepsis , composed of detoxified BAC00Escherichia_coli_J5 lipopolysaccharide (LPS) complexed with the outer membrane protein (OMP) of BAC00Neisseria_meningitidis group B, induces anti-core glycolipid antibody and has been tested in pilot studies in human volunteers.	experimental vaccine
Here we show the existence in septicemic BAC00E0_coli strains of an ETT2 gene cluster, ETT2( DIS00sepsis ), which, although degenerate, contributes to pathogenesis.	None
ETT2( DIS00sepsis ) has several premature stop codons and a large (5 kb) deletion, which is conserved in 11 BAC00E0_coli strains from cases of DIS00septicemia and DIS00newborn_meningitis .	from
The single episode of early-onset DIS00sepsis was caused by BAC00Listeria_monocytogenes , while all remaining episodes were late-onset with the following organisms: BAC00Staphylococcus_epidermidis (7), methicillin-resistant BAC00Staphylococcus_aureus (MRSA) (3), combined MRSA and Candida albicans (2), Candida albicans alone (2), late-onset Group B beta-hemolytic BAC00Streptococcus (GBS) (2), BAC00Klebsiella_pneumoniae (2), BAC00Enterococcus fecalis (1), BAC00Escherichia_coli (1), and BAC00Serratia_marcescens (1).	cause
In contrast to TLR4-deficient mice, SPRET/Ei mice resist both DIS00LPS and DIS00sepsis induced with BAC00Klebsiella_pneumoniae .	induce
METHODS: BAC00E0_coli was injected intraperitoneally to produce rats DIS00sepsis models.	inject
When mice were treated with ginsan before the bacterial challenge with BAC00S0_aureus , they were highly protected from DIS00sepsis -induced DIS00death .	None
DIS00Sepsis due to BAC00Staphylococcus_aureus was associated with vascular and joint devices whereas BAC00Pseudomonas_aeruginosa and Gram-negative rods were more common with genitourinary devices and DIS00lymphoproliferative_disease .	due to
INTRODUCTION: BAC00Streptococcus_suis is a BAC00bacterium causing a DIS00disease in pigs and rarely in humans.	cause
Finally, the protective effect of chronic acid water feeding on gut-derived DIS00sepsis due to BAC00P0_aeruginosa was tested in mice.	due to
Chronic acid water feeding protected mice from the lethal gut derived DIS00sepsis due to BAC00P0_aeruginosa .	due to
Adult male DIS00Wistar_rats (i) were given an intraperitoneal injection of 1 mg BAC00Escherichia_coli 0111:B4 DIS00LPS , (ii) were given 2 x 10(10) CFU of BAC00Escherichia_coli_ATCC_25922 , or (iii) had DIS00intra0abdominal_sepsis induced via cecal ligation and puncture.	None
OBJECTIVE: To evaluate the utility of PCT in distinguishing DIS00community0acquired_pneumonia (CAP) due to common bacteria, BAC00Mycobacterium_tuberculosis and DIS00Pneumocystis_jirovecii in a high DIS00human_immunodeficiency_virus ( DIS00HIV ) prevalence setting.	 due to
Pharmacological inhibition of apoptosis in wild-type mice by intravenous injection of the broad-spectrum caspase inhibitor zVAD-cmk mimicked the phenotype of Gfi1-deficient mice and resulted in a profound sensitization of mice to BAC00P0_aeruginosa , an increased release of cytokines, DIS00sepsis and death of the animals.	None
Continuous infusion of Intralipid (0.9 g/100 g bw/d) or saline (controls) was started immediately after induction of DIS00hyperdynamic_intra0abdominal_sepsis (bacterial agents: BAC00E0_coli , B. thetaiotamicron).	bacterial agent
The purpose of this study was to evaluate the direct effect of genistein on the survival and growth of the probiotic BAC00Lactobacillus_reuteri and selected opportunistic bacteria in vitro as a prelude to in vivo use for managing postirradiation DIS00sepsis	None
BAC00Vibrio_vulnificus is Gram-negative BAC00bacterium that contaminates oysters, causing highly lethal DIS00sepsis after consumption of raw oysters and wound DIS00infection .	cause
BAC00Yersinia_pestis causes bubonic DIS00plague , characterized by an enlarged, DIS00painful_lymph_node , termed a bubo, that develops after bacterial dissemination from a fleabite site.	cause
The fulminant progression of DIS00disease has been largely ascribed to the ability of BAC00Y0_pestis to avoid phagocytosis and exposure to antimicrobial effectors of innate immunity.	ascribe
tudies that define natural responses to bacterial DIS00sepsis assumed new relevance after the lethal bioterrorist attacks with BAC00Bacillus_anthracis ( DIS00anthrax ), a spore-forming, toxigenic gram-positive bacillus.	None
In the present study, the effect of morphine withdrawal on spontaneous DIS00sepsis and on DIS00oral_infection with BAC00Salmonella_enterica serovar Typhimurium was examined.	with
Oleuropein, a novel immunomodulator derived from olive tree, was assessed in vitro and in experimental DIS00sepsis by BAC00Pseudomonas_aeruginosa .	by
In DIS00cystic_fibrosis ( DIS00CF ), bacteria of the BAC00Burkholderia_cepacia complex (Bcc) can induce a DIS00fulminant_inflammation with DIS00pneumonitis and DIS00sepsis .	induce
BAC00Streptococcus_pneumoniae and BAC00Streptococcus_agalactiae cause distinct DIS00infectious_diseases in small children.	cause
DIS00Primary_infectious_disease issues included DIS00endocarditis , DIS00tracheitis , DIS00pneumonia , or central line DIS00sepsis resulting from BAC00Staphylococcus_epidermidis , methicillin-resistant BAC00Staphylococcus_aureus , and BAC00Enterococcus .	result
The 50% protective doses were <or=1 mg/kg of body weight against BAC00S0_aureus in the DIS00sepsis model, while decreases in the numbers of CFU per thigh equal to or greater than those detected in animals treated with a standard dose of vancomycin were seen in the animals with thigh DIS00infections .	None
BAC00Neisseria_meningitidis is a human pathogen that causes DIS00septicemia and DIS00meningitis with high mortality.	pathogen, cause
Because the clinical symptoms and signs of DIS00necrotizing_fasciitis and DIS00sepsis caused by these two bacteria are similar, the purposes of this study were to describe the clinical characteristics of BAC00Vibrio_vulnificus and DIS00Aeromonas_infections , to analyze the risk factors for DIS00death , and to compare the effects of surgical treatment on the outcome.	None
METHODS: The cases of thirty-two patients with necrotizing soft-tissue DIS00infections and DIS00sepsis caused by BAC00Vibrio_vulnificus (seventeen patients) and BAC00Aeromonas species (fifteen patients) were retrospectively reviewed over a four-year period.	cause
CONCLUSIONS: The contact history of patients with a rapid onset of DIS00cellulitis can alert clinicians to a differential diagnosis of soft-tissue DIS00infection with BAC00Vibrio_vulnificus (contact with seawater or raw seafood) or BAC00Aeromonas species (contact with fresh or brackish water, soil, or wood).	with
To investigate the influence of iNOS, we studied models of acute bacterial DIS00sepsis using acute challenges with aerobic ( BAC00Escherichia_coli ) and anaerobic ( BAC00Bacteroides_fragilis ) bacteria in the presence of AG.	None
BAC00Klebsiella_pneumoniae is an important cause of nosocomial Gram-negative DIS00sepsis .	cause
Endosialidase (endo-N-acetylneuraminidase) is a tailspike enzyme of bacteriophages specific for human pathogenic BAC00Escherichia_coli_K1 , which specifically recognizes and degrades polySia (polysialic acid). polySia is also a polysaccharide of the capsules of other DIS00meningitis - and DIS00sepsis -causing bacteria, and a post-translational modification of the NCAM (neural cell-adhesion molecule).	None
METHODS: DIS00Neutropenic mice with BAC00Escherichia_coli or DIS00Pseudomonas_aeruginosa_sepsis were treated with ceftazidime or meropenem 10-320 mg/kg as an intravenous bolus or as continuous tail vein infusions of 0.1 mL/h.	with
METHODS: Circulating concentrations of MIF were measured in 2 clinical trial cohorts of 145 pediatric and adult patients who had severe DIS00sepsis or DIS00septic_shock caused predominantly by DIS00infection with BAC00Neisseria_meningitidis or other gram-negative bacteria, to study the kinetics of MIF during DIS00sepsis , to analyze the interplay between MIF and other mediators of DIS00sepsis or stress hormones (adrenocorticotropic hormone and cortisol), and to determine whether MIF is associated with patient outcome.	with
Presented herein is the case of a 29 year old woman with CGD who suffered from DIS00bacteria0associated_haemophagocytic_syndrome and a DIS00septic_pulmonary_embolism following a uterine DIS00infection and DIS00sepsis , caused by BAC00Burkholderia_cepacia complex.	cause
Gram-negative organisms were isolated in 66 cases (31.43%), and the most common Gram-negative organism causing DIS00neonatal_sepsis was BAC00Klebsiella_pneumoniae .	cause
The distribution of the main pathogens is different in the Azerbaijan state, northwest of Iran, and BAC00K0_pneumoniae is predominant, but BAC00Streptococcus_agalactiae plays a relatively minor role in the etiology of DIS00sepsis during the first month of life.	etiology
METHODS: Peritoneal DIS00sepsis was induced in mice expressing either functional TLR4 (TLR4-wild-type [WT]) or mutant TLR4 by intraperitoneal injection of either live BAC00Escherichia_coli or DIS00LPS .	None
CONCLUSIONS: We conclude that TLR4 plays a critical role in the response to intraperitoneal BAC00E0_coli through effects on phagocytosis by macrophages, suggesting the possibility of using TLR4 as a therapeutic target in DIS00diseases of peritoneal DIS00sepsis .	None
BAC00S0_epidermidis is a leading cause of nosocomial DIS00sepsis , with virulence residing in its ability to establish DIS00chronic_infections through production of slime layers, or biofilms, on biomedical devices.	cause
RESULTS: We report data on spontaneous DIS00meningitis and DIS00brain_infection following oral DIS00infection of mice with BAC00Salmonella_enterica serovar Typhimurium.	with
CGD mice, challenged intratracheally with 10(3) cells of the epidemic BAC00Burkholderia_cenocepacia strain J2315, died within 3 days from DIS00sepsis after bacteria had multiplied to 3.3 x 10(8) cells.	None
BAC00Streptococcus_suis , an important swine and human pathogen, causes DIS00septic_shock and DIS00meningitis .	cause
METHODS: An experimental model of gram-positive DIS00sepsis was used in which liver-specific gp130-deficient mice (FVB/n alfpCre+ gp130(LoxP/LoxP)) and wild-type mice (FVB/n gp130(LoxP/LoxP)) were intravenously infected with BAC00Streptococcus_pyogenes .	None
To determine the role of the CD14 DIS00LPS receptor in the pathogenic effects of naturally occurring BAC00E0_coli , the responses of CD14-/- and CD14+/+ mice to three different isolates of BAC00E0_coli obtained from DIS00sepsis patients were compared; two isolates express both smooth DIS00LPS and the K1 antigen, while the third isolate expresses only DIS00LPS and is negative for K1.	from
Immunological reactivity of the antigens mixture with two human sera: highly positive (with three BAC00S0_aureus antigens in ELISA) from patient with staphylococcal DIS00sepsis and negative (from blood donor) were analysed.	from
Mortality was associated with age (P=0.005), a previous history of DIS00coronary_heart_disease (P=0.016), DIS00absence_of_fever (P=0.001), development of DIS00sepsis and/or DIS00septic_shock (P<0.001), raise of bilirubin levels (P=0.004), a biliary (P=0.035), or cryptogenetic origin (P=0.039), DIS00infection owing to BAC00E0_coli (P=0.01) or to Candida (P=0.009) and development of DIS00pneumonia (P<0.001).	None
The authors report the first case of methicillin-resistant BAC00Staphylococcus_aureus (MRSA) DIS00meningitis in a patient with such a pump successfully treated with linezolid without the need for removal of the intrathecal pump.	None
The BAC00Staphylococcus_aureus cell surface protein clumping factor A (ClfA) and the enzyme sortase A (SrtA), which attach surface proteins to the cell wall, have both been shown to be virulence factors in models of DIS00septic_arthritis and DIS00sepsis .	virulence factors
The mRNA levels of clfA, srtA and the putative housekeeping gene gyrase B (gyrB) in BAC00S0_aureus were determined using real-time PCR during the course of DIS00sepsis0septic_arthritis .	None
We used ciprofloxacin to induce a predominantly gram-positive BAC00Enterococcus_faecalis polymicrobial DIS00sepsis in rats.	None
AIMS: The aim of the study was to evaluate the efficacy of probiotics on gut-derived DIS00sepsis caused by BAC00Pseudomonas_aeruginosa in immunocompromised mice.	cause
METHODS AND RESULTS: After oral inoculation of BAC00P0_aeruginosa , mice were treated with cyclophosphamide to induce DIS00leucopenia and translocation of the intestinal BAC00P0_aeruginosa into blood, thereby producing gut-derived DIS00sepsis .	produce
CONCLUSION: Oral administration of BAC00B0_longum protects mice against gut-derived DIS00sepsis caused by BAC00P0_aeruginosa , and the effect may be due to interference of BAC00P0_aeruginosa adherence to intestinal epithelial cells.	cause
The FcRgamma-associated receptor that inhibits BAC00E0_coli phagocytosis is FcgammaRIII (also called CD16), and its absence protects mice from DIS00sepsis .	None
Cephtriaxon is the drug of choice for BAC00E0_coli and DIS00Hemophilus_influence_meningitis .	None
In DIS00acute_meningitis of prematures already colonized with BAC00U0_urealyticum , ureaplasmal cultures and susceptibility test are warranted in Korea.	colonize
In this Commentary, we consider these findings and propose possible mechanisms by which RAGE exacts a heavy toll on the host in response to polymicrobial DIS00sepsis and BAC00L0_monocytogenes .	None
Methicillin-resistant BAC00Staphylococcus_aureus (MRSA), BAC00Pseudomonas_aeruginosa and BAC00Acinetobacter_baumannii were predominant causative agents in both type of DIS00sepsis .	causative agents
BAC00E0_coli hemolysin and, possibly, other related cytolysins may thus contribute directly to the pathogenesis of DIS00acute_respiratory_failure under conditions of DIS00sepsis or DIS00pneumonia .	contribute
BAC00Staphylococcus_aureus is a known cause of a variety of illnesses that present to the emergency department, including DIS00skin_and_soft_tissue_infections , DIS00pneumonia , and DIS00sepsis .	contribute
DIS00Lemierre0s_syndrome is characterized by severe DIS00infection , with DIS00pharyngitis , DIS00sepsis and DIS00thrombosis of the internal jugular vein, and is most frequently associated with DIS00upper_airway_infection with BAC00Fusobacterium_necrophorum , often preceded by DIS00infection with DIS00Epstein0Barr_virus which enables bacteria growing in the oral cavity to invade.	with
We developed a live BAC00Escherichia_coli model of acute DIS00sepsis in pigs with emphasize on biomarkers reflecting the early inflammatory response of DIS00sepsis .	None
The aim of this study was to analyze if these two amino acids which are vital for the fibrinogen binding of ClfA are of importance for the ability of BAC00S0_aureus to generate DIS00disease .	generate
Our data strongly suggest that the fibrinogen binding activity of ClfA is crucial for the ability of BAC00S0_aureus to provoke DIS00disease manifestations, and that the vaccine potential of recombinant ClfA is improved by removing its ability to bind fibrinogen.	provoke
CONCLUSIONS: BAC00B0_cepacia may be an etiologic agent of severe hospital acquired DIS00pneumonia and DIS00sepsis among immunocompromised patients. DIS00Clinically_infection develops picture of superinfection and usually is life-threatening condition.	etiologic agent
BAC00Streptococcus_suis is a major cause of DIS00meningitis , DIS00sepsis and DIS00arthritis in piglets and a zoonotic agent.	cause
Based on favorable sensitivity data, penetration into neutrophils and the CNS, and favorable DIS00toxicity profiles, ciprofloxacin and meropenem would appear to be the most appropriate antibiotic treatment options for DIS00systemic_infection_or_meningitis caused by BAC00C0_koseri .	cause
CONCLUSIONS: Ciprofloxacin and meropenem should be considered antibiotic treatment options for DIS00systemic_infection_or_meningitis caused by BAC00C0_koseri .	cause
In this model mimicking human DIS00disease , the inflammatory response to BAC00N0_meningitidis was closely associated with the bacterial concentration.	None
BAC00Staphylococcus_aureus is a common etiologic agent for Gram-positive DIS00sepsis , and its lipoteichoic acid (LTA) may be important in causing Gram-positive bacterial DIS00septic_shock .	etiologic agent
It is frequently caused by BAC00S0_aureus and, in endemic areas, by BAC00Mycobacterium_tuberculosis and BAC00Brucella spp. We describe 9 cases, from October 2004 to August 2005, all spontaneous DIS00diseases occurring in adults (mean age 64 years).	None
Upon BAC00E0_coli inoculation, Cyld(-/-) mice were hypersusceptible to DIS00E0_coli_pneumonia with higher mortality.	hypersusceptible
We presently have demonstrated that recombinant N-terminal lectinlike domain of TM (rTMD1) functions as a protective agent against DIS00sepsis caused by Gram-negative bacterial DIS00infections . rTMD1 caused agglutination of BAC00Escherichia_coli and BAC00Klebsiella_pneumoniae and enhanced the macrophage phagocytosis of these Gram-negative bacteria.	cause
BAC00Neisseria_meningitidis is a leading cause of DIS00meningitis and DIS00septicemia worldwide, with a rapid onset of DIS00disease and a high morbidity and mortality.	cause
Swine influenza virus (SIV) and BAC00Streptococcus_suis are common pathogens of the respiratory tract in pigs, with both being associated with DIS00pneumonia .	associate
BAC00Ehrlichia_chaffeensis , a tick-borne rickettsial organism, causes the DIS00disease human monocytic DIS00ehrlichiosis .	cause
DIS00Tuberculosis is primarily a DIS00respiratory_disease that is caused by BAC00Mycobacterium_tuberculosis .	cause
The emergence of new antibiotic-resistant BAC00Escherichia_coli pathotypes associated with human DIS00disease has led to an investigation in terms of the origins of these pathogens.	associate
It is hypothesized that environmental BAC00E0_coli not typically associated with the ability to cause DIS00disease in humans could potentially be responsible for some of these cases	cause
Under field conditions, DIS00co0infection of AvRVs occurs with other infectious agents such as astroviruses, enteroviruses, reoviruses, paramyxovirus, adenovirus, BAC00Salmonella , BAC00Escherichia_coli , cryptosporidium and Eimeria species prospering severity of DIS00disease outcome.	infectious agent
Birds surviving to DIS00RV_disease predominantly succumb to secondary DIS00bacterial_infections , mostly BAC00E0_coli and BAC00Salmonella spp.	None
UNASSIGNED: Non-typeable BAC00Haemophilus_influenzae (NTHi) live exclusively in the pharynges of humans and are increasingly recognized as pathogens that cause both localized DIS00infections of the respiratory tract (middle ear spaces, sinuses, and bronchi) and DIS00systemic_infections such as DIS00bacteraemia and DIS00pneumonia .	cause
Clarifying the mechanism that underlies the QS system between BAC00S0_gordonii and BAC00V0_tobetsuensis may lead to the development of novel methods for the prevention of oral DIS00infectious_diseases caused by oral biofilms.	None
BAC00Pasteurella_multocida is a Gram-negative bacterial pathogen causing economically important DIS00diseases in distinct animal species.	cause
BACKGROUND: The epidemiology of DIS00salmonellosis is complex because of the diversity and different serotypes of BAC00Salmonella_enterica ( BAC00S0_enterica ) that occur in different reservoirs and geographic incidences.	None
Pneumococcal conjugate vaccines target the limited subset of the more than 90 known serotypes of BAC00Streptococcus_pneumoniae responsible for the greatest burden of DIS00pneumococcal_disease and antibiotic resistance.	responsible
This study suggests that these compounds represent potential natural molecules for the prevention and treatment of BAC00H0_pylori associated DIS00diseases .	associate
Individual Arabidopsis GAPDH knockouts (KO lines) exhibited enhanced DIS00disease resistance phenotypes upon inoculation with the bacterial plant pathogen BAC00Pseudomonas_syringae_pv0_tomato .	pathogen
ge, betel chewing, and a microbiological cluster including at least one of BAC00Prevotella_tannerae , BAC00Filifactor_alocis and BAC00Porphyromonas_endodontalis significantly correlated with the severity of DIS00periodontal_disease .	correlate
UNASSIGNED: Recently it has been estimated that the annual cost of DIS00diseases caused by the waterborne pathogens DIS00Legionella_pneumonia , BAC00Mycobacterium_avium , and BAC00Pseudomonas_aeruginosa is  500 million.	cause
For the period 2001-2012, the estimated cost of hospital admissions for DIS00nontuberculous_mycobacterial_pulmonary_disease , the majority caused by BAC00M0_avium , was almost  1 billion.	cause
BAC00Aerococcus_viridans is a wide spread BAC00bacterium in the environment and clinically this organism is associated with different DIS00diseases in animals and humans.	associate
The aim of this study was to test the antitumor potential of a combination of melatonin and BAC00P0_acnes against DIS00breast_cancer implanted in mice.	against
The combination of melatonin and BAC00P0_acnes has high efficiency in targeting DIS00breast_cancer in mice.	efficiency
The combination of melatonin and BAC00P0_acnes represents a promising option to treat DIS00breast_cancer .	treat
Antibacterial activity of the prepared formulations was evaluated against clinical strains of BAC00Helicobacter_pylori , isolated from gastric biopsies of patients with DIS00gastritis , DIS00duodenal_ulcer , peptic DIS00ulcer , and DIS00gastroesophageal_reflux_disease undergoing endoscopy, by using agar dilution method.	isolate
For the first time in decades, most (60%) infants with early-onset DIS00sepsis were very low birth weight and BAC00Escherichia_coli (45%) replaced group B streptococcus (36%) as the most common organism associated with early-onset DIS00sepsis .	None
DIS00Yersiniosis caused by BAC00Yersinia_enterocolitica has been reported from all continents.	cause
The occurrence of pathogenic BAC00Escherichia_coli in environmental waters increases the risk of DIS00waterborne_disease .	increase the risk
OBJECTIVE: To evaluate the efficacy ofprobiotics, BAC00Lactobacillus_casei (Shirvta strain), in reducing the incidence ofventilator- associated DIS00pneumonia (VAP) in medical patients who received mechanical ventilation at Siriraj Hospital.	None
Although metronidazole resulted in transient loss of colonization resistance, oral vancomycin markedly disrupted the microbiota, leading to prolonged loss of colonization resistance to DIS00C0_difficile_infection and dense colonization by vancomycin-resistant BAC00Enterococcus , BAC00K0_pneumoniae , and BAC00E0_coli .	None
Free-range pigs can be infected by BAC00Mycobacterium_tuberculosis complex (MTC) and may contribute to the spread of DIS00bovine_tuberculosis (bTB).	contribute
RESULTS: BAC00M0_genitalium serum IgG was more common among women of DIS00infertile couples (5.4%) than among fertile controls (1.6%) (OR (95%CI) 3.45 (1.10 to 10.75)), adjusting for DIS00C0_trachomatis_IgG (adjusted OR=3.00 (0.95 to 9.47)).	common
CONCLUSIONS: BAC00M0_genitalium serum IgG was associated with DIS00infertility in women, however insignificant after adjustment for DIS00C0_trachomatis_IgG , but not with DIS00infertility subtypes within this study.	associate
The effect of the glucans on DIS00disease resistance was then evaluated by experimentally infecting the fish with BAC00Edwardsiella_ictaluri by immersion and mortalities monitored for 14 days.	infect
OBJECTIVES: With accurate molecular tests now available for diagnosis of DIS00chlamydia_and_gonorrhoea_0Chlamydia_trachomatis (CT)/ BAC00Neisseria_gonorrhoeae (NG)) at the point-of-care (POC), we aimed to explore the public health implications (benefits and barriers) of their integration into remote primary care in Australia.	None
However, production of this prawn is facing a serious threat from DIS00Vibriosis_disease caused by BAC00Vibrio species such as BAC00Vibrio_parahaemolyticus .	cause
BAC00T0_denticola (P = 0.001), BAC00T0_forsythia (P < 0.001), and P. micros (P = 0.003) are significantly associated with DIS00periodontal_disease in CKD subjects but in a multivariate model only age and BAC00T0_forsythia remain independent risk factors for DIS00periodontal_disease in patients with CKD.	associate
The next aim was to evaluate the incidence of DIS00S0_agalactiae_early_onset_sepsis in newborns from PPROM pregnancies, with respect to the presence of BAC00S0_agalactiae in the vagina and the amniotic fluid.	incidence, presence
DIS00Early_onset_neonatal_sepsis developed in one newborn from pregnancies complicated by the presence of BAC00S0_agalactiae in the amniotic fluid.	by
Cultivation-negative findings of BAC00S0_agalactiae in the vagina did not exclude the positivity of the amniotic fluid for BAC00S0_agalactiae and the development of early onset DIS00sepsis in newborns.	None
We used novel real-time multiplex PCR assays to detect BAC00S0_aureus , MRSA, BAC00E0_coli , BAC00P0_aeruginosa , BAC00S0_pneumoniae , H. DIS00influenza and BAC00Acinetobacter spp.	None
Enterotoxin-producing BAC00Escherichia_coli (ETEC) are one of the main causative agents of DIS00diarrhea in children especially in developing countries and travel DIS00diarrhoea in adults.	causative agent
BAC00Rickettsia_typhi is the causal agent of DIS00murine_typhus ; a worldwide zoonotic and vector-borne DIS00infectious_disease , commonly associated with the presence of domestic and wild rodents.	causal agent
BAC00Leptospira_interrogans has been identified to cause DIS00leptospirosis , a widespread DIS00zoonotic_disease that has been identified in domestic and wild animals.	cause
BACKGROUND: Globally, over 800 000 children under five die each year from DIS00infectious_diseases caused by BAC00Streptococcus_pneumoniae .	cause
Discussion These results demonstrate that CGK fermented by mixed culture of BAC00B0_subtilis and BAC00L0_sakei could exert a wide range of beneficial activities for DIS00neurodegenerative_diseases , including DIS00Alzheimer , DIS00Parkinson , and DIS00Huntington_disease .	beneficial activitie
The oral clinical examination to assess DIS00periodontal_disease ; gingival fluid sample collection for quantification of the periodontopathogenic bacteria BAC00Porphyromonas_gingivalis , BAC00Tannerella_forsythia , BAC00Treponema_denticola , and BAC00Prevotella_intermedia using q-PCR; DIS00body_mass_index (BMI) and for collection of the individual's health-related data from medical files.	None
CONCLUSION: The DIS00periodontal_disease increased in severity and BAC00P0_gingivalis increased after GBS.	None
To identify the immune mechanisms responsible for ineffective clearance of BAC00Coxiella_burnetii in patients who developed DIS00chronic_Q_fever , we compared serum concentrations of 47 DIS00inflammation -associated markers among patients with DIS00acute_Q_fever , vascular DIS00chronic_Q_fever , and past resolved DIS00Q_fever .	None
Serum responses for these and other markers indicate that type I immune responses to BAC00C0_burnetii are affected in DIS00chronic_Q_fever patients.	affect
UNASSIGNED: BAC00Salmonella_enterica serovar Pullorum (S. Pullorum) is a highly adapted pathogen that causes DIS00Pullorum_disease (PD), an important systemic DIS00disease of poultry that causes severe economic losses in developing countries.	pathogen, causes
This 3-mAb combination protected animals against mortality and also reduced severity and duration of DIS00diarrhea associated with challenge with highly virulent strains of BAC00C0_difficile toxinotypes 0 and III.	associate
UNASSIGNED: The well-established safety profile of the DIS00tuberculosis vaccine strain, BAC00Mycobacterium_bovis bacille Calmette-Gu  rin (BCG), makes it an attractive vehicle for heterologous expression of antigens from clinically relevant pathogens.	None
UNASSIGNED: BAC00Burkholderia_gladioli was described as a plant pathogen, and it is a rare cause of DIS00infection in humans B56hat is primarily associated with human DIS00pulmonary_infections , such as DIS00chronic_granulomatous_disease and DIS00cystic_fibrosis .	cause
Of the 2,676 participants, 87 (3.25  %) had a positive BAC00B0_gladioli blood culture that occurred >72  h after birth, including a premature group (54.0  %, DIS00asphyxia [vs. 9.20  %], DIS00fever [vs. 13.80  %], DIS00pneumonia [vs. 6.90  %] and DIS00hyperbilirubinaemia [vs. 8.05  %]) and newborns with DIS00necrotising_enterocolitis ( DIS00NEC ) (vs. 5.75  %).	None
DIS00Invasive_meningococcal_disease ( DIS00IMD ) caused by BAC00Neisseria_meningitidis serogroup Y has increased in Europe, especially in Scandinavia.	cause
UNASSIGNED: BAC00Shigella_sonnei , an emerging global cause of DIS00shigellosis , consists of four distinct lineages and the current pandemic involves several geographically associated, multidrug-resistant clones that belong to lineage III (1-3).	cause
UNASSIGNED: BAC00Haemophilus_influenzae type b (Hib) is, in contrast to non-b BAC00H0_influenzae , associated with severe DIS00invasive_disease such as DIS00meningitis and DIS00epiglottitis in small children.	associate
Hansen A/S) (hereafter, BAC00L0_casei 431) on immune response to DIS00influenza vaccination and respiratory symptoms in healthy adults.	None
Subjects were randomly assigned to receive an acidified milk drink containing >= 10(9) colony-forming units of BAC00L0_casei 431 (n = 553) or placebo (n = 551) for 42 d. After 21 d, subjects received the seasonal DIS00influenza vaccination.	None
RESULTS: There was no effect of BAC00L0_casei 431 on immune responses to DIS00influenza vaccination.	response
CONCLUSIONS: Daily consumption of BAC00L0_casei 431 resulted in no observable effect on the components of the immune response to DIS00influenza vaccination but reduced the duration of upper respiratory symptoms.	no
A carbapenem-nonsusceptible BAC00Enterobacter_aerogenes strain named 3-SP was isolated from a human case of DIS00pneumonia in a Chinese teaching hospital.	isolate
The objectives of this study were to assess the prevalence of DIS00bacterial_vaginosis in women attending Gynaecology Outpatient Department (O.P.D) and sexually transmitted DIS00disease (S.T.D.) clinic and to assess the role of BAC00Gardnerella_vaginalis as an etiological agent of DIS00bacterial_vaginosis .	etiological agent
BAC00Gardnerella_vaginalis was isolated in only 8.7% cases of DIS00bacterial_vaginosis .	isolate
UNASSIGNED: BAC00Streptococcus_pneumoniae is a rarely cause of DIS00neonatal_sepsis .	cause
Measures to prevent BAC00Streptococcus_agalactiae transmission could help to increase DIS00Invasive_Pneumococcal_Disease ( DIS00IPD ) in newborns.	increase
CONCLUSION: In neonatal DIS00sepsis , we always think in BAC00Streptococcus_agalactiae .	None
BACKGROUND: DIS00Plague , a DIS00zoonotic_disease caused by BAC00Yersinia_pestis , is characterized by its ability to persist in the DIS00plague natural foci.	cause
On July 8, 2014, the Colorado Department of Public Health and Environment (CDPHE) laboratory identified BAC00Yersinia_pestis , the BAC00bacterium that causes DIS00plague , in a blood specimen collected from a man (patient A) hospitalized with DIS00pneumonia .	cause
This outbreak highlights 1) the need to consider DIS00plague in the differential diagnosis of ill domestic animals, including dogs, in areas where DIS00plague is endemic; 2) the limitations of automated diagnostic systems for identifying rare bacteria such as BAC00Y0_pestis0 and 3) the potential for milder DIS00plague illness in patients taking antimicrobial agents.	None
DIS00Hospital_laboratorians should be aware of the limitations of automated identification systems, and clinicians should suspect DIS00plague in patients with clinically compatible symptoms from whom BAC00P0_luteola is isolated.	None
BACKGROUND: The bacteria BAC00Orientia_tsutsugamushi is the causative agent of DIS00scrub_typhus , mite-borne DIS00disease , which causes an DIS00acute_febrile_illness in patients.	causative agent
Serogroup A of BAC00Neisseria_meningitidis is the organism responsible for causing DIS00epidemic_diseases in developing countries by a pilus-mediated adhesion to human brain endothelial cells.	cause
Pathogens of interest included: bovine DIS00viral_diarrhea_virus (BVDV), bovine herpesvirus type 1 (BHV-1), parainfluenza-3 virus, bovine DIS00respiratory_syncytial_virus , DIS00Mannheimia_haemolytica0_Mycoplasma_bovis , Pastuerella multocida, and BAC00Histophilus_somni .	None
Surprisingly, we found extensive cross-talk among the DIS00M0_tuberculosis_TCSs , significantly more than that in the TCSs in BAC00Escherichia_coli or BAC00Caulobacter crescentus, thereby offering an alternate to specificity paradigm in TCS signalling.	None
The following bacteria were isolated and cultured from both groups with no meaningful difference in prevalence: BAC00Streptococcus viridans (p = 0.265), BAC00Staphylococcus_aureus (p = 0.72), H. DIS00influenza (p = 0.806), Entrococcus.	None
Fourteen cases were caused by BAC00Fusobacterium_necrophorum , including four cases with CSVT, 7/8 cases of DIS00mastoiditis , four of them with DIS00subperiosteal_abscess formation; all four cases with DIS00meningitis and two brain abscesses.	cause
UNASSIGNED: Early signs of DIS00pulmonary_disease with BAC00Mycobacterium_abscessus complex (MABSC) can be missed in patients with DIS00cystic_fibrosis ( DIS00CF ).	miss
BAC00Brucella_abortus is the etiologic agent of DIS00Brucellosis , a DIS00zoonotic_infection affecting a wide range of animals.	etiologic agent
OBJECTIVES: DIS00Yersiniosis , a DIS00foodborne_infection of zoonotic origin caused by the bacteria BAC00Yersinia_enterocolitica and BAC00Yersinia_pseudotuberculosis , is a reportable DIS00disease in 38 states.	cause
Although only BAC00B0_pseudomallei is responsible for a significant number of human cases, both organisms are classified as Tier 1 Select Agents and their DIS00diseases lack effective diagnosis and treatment.	responsible
The DIS00AdvanSure_tuberculosis /non- DIS00tuberculous_mycobacterium (TB/NTM) PCR (LG Life Science, Korea) and COBAS TaqMan BAC00Mycobacterium_tuberculosis ( DIS00MTB ) PCR (Roche Diagnostics, USA) are commonly used in clinical microbiology laboratories.	None
His hospital course is described and reveals an DIS00encephalopathy caused by the BAC00Bartonella_henselae_bacterium also known as cat-scratch DIS00disease .	cause
UNASSIGNED: BAC00Campylobacter_jejuni is one of the most common bacterial causes of human DIS00gastroenterocolitis worldwide, leading to DIS00diarrhea and other serious post-infectious complications.	cause
This review has collated the studies conducted using probiotics to inhibit BAC00C0_jejuni colonization and growth to date to provide a collective knowledge about the role of probiotics as an alternative intervention strategy for DIS00campylobacteriosis .	None
UNASSIGNED: DIS00Contagious_equine_metritis (CEM) is a DIS00bacterial_infectious_disease of horses caused by BAC00Taylorella_equigenitalis , a Gram-negative eu BAC00bacterium .	cause
Our study highlights that seabirds from the north-eastern Atlantic Ocean are carrying several DIS00chlamydial_organisms , including BAC00C0_psittaci0related strains.	include
BAC00Xanthomonas_arboricola is divided into pathovars, some of which are classified as quarantine organisms in many countries and which are responsible for DIS00diseases on nut and stone fruit trees that have emerged worldwide.	responsible
Majority of DIS00brucellosis cases were caused by BAC00B0_melitensis0 only one index case was linked to BAC00B0_abortus .	cause
This case indicates that BAC00C0_difficile may not only be related to DIS00diarrheic_diseases , but also to DIS00infections of non-healing wounds, especially in situations when BAC00C0_difficile is the only isolated pathogen.	relate
BAC00Trueperella_pyogenes , BAC00Staphylococcus_aureus , BAC00Pseudomonas_aeruginosa , DIS00Klebsiella_pneumonia , BAC00Streptococcus zooepidemicus, and b-hemolytic BAC00Streptococcus were isolated from females presented for repeat DIS00breeding_syndrome .	isolate
BAC00Streptococcus_pneumoniae is a common cause of DIS00infectious_diseases in children that may lead to life-threatening complications.	cause
By comparing the whole genomes of BAC00S0_sonnei isolated from vaccinees and from volunteers in the control group, we show at a very high sensitivity that a potent BAC00S0_sonnei glycoconjugate that conferred 74% protective efficacy against the homologous DIS00disease did not induce changes in the genome of BAC00S0_sonnei and in particular on the O-antigen gene cluster.	None
Our results showed that OW-14 adjuvanted inactivated swine influenza viruses (SIV; H3N2 and H1N1) and BAC00Mycoplasma_hyopneumoniae ( DIS00M0_hyo ) vaccines could be safely administered to piglets in two doses, three weeks apart.	None
UNASSIGNED: The effect of BAC00Lactobacillus_casei administered along with a live DIS00attenuated_vaccine_vs0_bovine_babesiosis (VAC) on induction of IgG1 and IgG2 antibodies to DIS00Babesia_bovis_and_Babesia_bigemina was assessed by the indirect fluorescent antibody test (IFAT) in bovines of an DIS00endemic_babesiosis area before (day 0) and after vaccination (days 15 and 30).	along
Most detectable gram-negative bacteria were BAC00E0_coli and DIS00Klebsiella_pneumonia .	None
DIS00Bacteremia and DIS00infective_endocarditis caused by BAC00Staphylococcus_aureus are common and severe DIS00diseases .	cause
Both DIS00bacteremia and DIS00infective_endocarditis caused by BAC00Staphylococcus_aureus are common and severe DIS00diseases .	cause
UNASSIGNED: Invasive DIS00Salmonellosis caused by DIS00Salmonella_enterica_serotype_Typhi or Paratyphi A, B, C, or invasive non-typhoidal BAC00Salmonella serotypes, is an immensely important DIS00disease cluster for which reliable, rapid diagnostic tests are not available.	cause
At species level, potential pathogens BAC00Arcobacter_butzleri , BAC00Aeromonas_hydrophila and DIS00Klebsiella_pneumonia dominated in raw sewage, which was also confirmed by quantitative real time PCR.	None
Because the human DIS00periodontal_disease pathogen, BAC00Porphyromonas_gingivalis (Pg), interacts with innate immune receptors Toll-like Receptor (TLR) 2 and CD36/scavenger receptor-B2 (SR-B2), we studied how CD36/SR-B2 and TLR pathways promote DIS00Pg0mediated_atherosclerosis .	pathogen
CONCLUSIONS: The isolation of the highly infectious pathogen BAC00B0_melitensis from seropositive workers is consistent with the notion that the pathogen may persist in the blood without causing overt DIS00disease .	None
While vaccination with strain S19 is essential for the control of bovine DIS00brucellosis the vaccine strain may be transmitted to the human population and protective measures remain important to prevent exposure also in view of the presence of BAC00B0_melitensis .	None
After establishing that mouse neutrophil elastase cleaves mouse HGF in vitro, we tested our predictions in vivo by examining lung pathology and HGF in mice infected with BAC00Mycoplasma_pulmonis , which causes DIS00neutrophilic_tracheobronchitis and DIS00pneumonia .	cause
The aquatic pathogen, BAC00Streptococcus_iniae , is responsible for over 100 million dollars in annual losses for the aquaculture industry and is capable of causing DIS00systemic_disease in both fish and humans.	cause
UNASSIGNED: BAC00Acinetobacter_baumannii is a multidrug-resistant pathogen associated with severe DIS00infections in hospitalized patients, including DIS00pneumonia , urinary and bloodstream DIS00infections .	pathogen, associate
The study objective was to investigate whether the strain of BAC00L0_monocytogenes serotype 1/2c isolated from DIS00neonatal_listeriosis carries a premature stop codon (PMSC) mutation in the inlA gene.	isolate
BACKGROUND: Several recent small studies have suggested a causal link between DIS00Lyme_disease and DIS00dilated_cardiomyopathy ( DIS00DCM ) by demonstrating the presence of the BAC00Borrelia_burgdorferi (Bb) genome in the myocardium of patients with recent-onset DIS00DCM .	None
BAC00C0_trachomatis isolates that cause DIS00trachoma , sexually transmitted DIS00genital_tract_infections ( DIS00chlamydia ) and DIS00invasive_lymphogranuloma_venereum ( DIS00LGV ), and the murine strain BAC00C0_muridarum share 99% of their gene content.	cause
These findings reveal adaptations of BAC00Y0_pestis to the dermis and how these adaptations can define the progression of DIS00disease .	progression
These results demonstrate a limited role for IL-17 signaling through IL-17RA in the development of DIS00disease following DIS00infection of C3H mice with BAC00B0_burgdorferi .	with
UNASSIGNED: BAC00Vibrio_cholerae is a genetically diverse species, and pathogenic strains can encode different virulence factors that mediate colonization and secretory DIS00diarrhea .	encode
UNASSIGNED: Obligate intracellular BAC00bacterium , BAC00Chlamydia_pneumoniae is not only a causative agent of community-acquired DIS00pneumonia , but is also associated with a more serious DIS00chronic_disease , DIS00asthma , which might be exacerbated by air pollution containing carbon nanoparticles.	causative agent
When exposed to germinants such as bile salts, BAC00C0_difficile spores return to life through germination in the gastrointestinal tract and cause DIS00disease , but their germination has only been studied with population-wide measurements.	cause
DIS00Immune_deficiencies caused by HIV give rise to DIS00numerous_opportunistic_gastrointestinal pathogens such as BAC00Helicobacter_pylori , the commonest cause of DIS00chronic_gastritis .	pathogen
BACKGROUND: BAC00Streptococcus_equi subspecies zooepidemicus ( BAC00Streptococcus zooepidemicus) is a rare cause of DIS00meningitis in humans.	cause
In this study, we characterized in vivo DNA binding and gene regulation by the cAMP-responsive protein CRP in BAC00M0_bovis_BCG as a model for DIS00tuberculosis ( DIS00TB )-complex bacteria.	model
UNASSIGNED: DIS00Urinary_tract_infections caused by uropathogenic BAC00E0_coli are among the most prevalent DIS00infectious_diseases .	cause
UNASSIGNED: DIS00Leprosy is a DIS00chronic_granulomatous_infection caused by the organism BAC00Mycobacterium_leprae that primarily affects the skin and peripheral nerves.	cause
UNASSIGNED: The present study aimed at investigating the potential anti- DIS00colon_cancer activity of three purified exopolysaccharides fractions (LHEPS-1, LHEPS-2 and LHEPS-3) from the BAC00Lactobacillus_helveticus MB2-1.	None
The goal of the study was to evaluate detection of poly-y-D-glutamic acid (PGA), the capsular antigen of BAC00B0_anthracis , as a biomarker surrogate for blood culture in a rabbit model of inhalational DIS00anthrax .	None
BACKGROUND: BAC00Streptococcus_pneumoniae is one major cause of DIS00pneumonia in human and contains various virulence factors that contribute to pathogenesis of DIS00pneumococcal_disease .	cause
OBJECTIVE: To investigate the effect of BAC00Helicobacter_pylori ( BAC00H0_pylori ) eradication on the expression level of the FHIT gene and its methylation status in the DIS00gastric_mucosa_of_dyspeptic patients with or without a family history of DIS00gastric_cancer (FHGC).	None
BAC00Anaplasma_marginale is an economically important tick-borne pathogen of cattle that causes bovine DIS00anaplasmosis .	cause
The potentials of BAC00Mycobacterium_leprae 65-kD heat-shock protein or Toll-like receptor 9 ligand (CpG oligodeoxynucleotides) as immune modulators for the treatment of DIS00airway_allergic_disease have been studied individually.	treatment
OBJECTIVES: BAC00Coxiella_burnetii is an obligate intracellular BAC00bacterium that is found worldwide, is associated or suggested to be associated with DIS00reproductive_abnormalities in a number of species including cats, and is the cause of DIS00Q_fever in humans.	associate
BAC00Legionella_pneumophila , the etiological agent of DIS00legionellosis , replicates within phagocytic cells.	agent
The DIS00syphilis spirochete BAC00Treponema_pallidum is an important human pathogen but a highly enigmatic BAC00bacterium that cannot be cultivated in vitro.	pathogen
IMPORTANCE: BAC00Treponema_pallidum , the DIS00syphilis spirochete, exploits its periplasmic lipoproteins for a number of essential physiologic processes.	None
Enteropathogenic BAC00Escherichia_coli (EPEC) uses a type III secretion system (T3SS) to directly translocate effector proteins into host cells where they play a pivotal role in subverting host cell signaling needed for DIS00disease .	None
AIM: To evaluate the incidence and clinical characteristics of DIS00gastric_cancer ( DIS00GC ) in peptic DIS00ulcer patients with BAC00Helicobacter_pylori ( BAC00H0_pylori ) DIS00infection .	None
BAC00Streptococcus_pneumoniae serotype 1 is one of the leading causes of DIS00invasive_pneumococcal_disease .	cause
BAC00Mycobacterium_bovis is the major causative agent of DIS00bovine_tuberculosis , one of the most relevant zoonoses in the world, and affects a wide range of wild and domesticated animals.	causative agent
Virulence factors of BAC00Helicobacter_pylori can predict the development of different DIS00gastroduodenal_diseases .	development
These findings suggest a mechanism for DIS00neutropenia in chronic DIS00brucellosis and reveal a novel BAC00Brucella0host cross-talk through which BAC00B0_abortus is able to hinder the innate function of PMN.	None
BAC00Salmonella_enterica serovar Typhi (S. Typhi) is a foodborne pathogen that causes DIS00typhoid_fever and DIS00infects only humans.	pathogen, cause
BAC00Pasteurella_multocida is an important pathogen in food-producing animals and numerous virulence genes have been identified in an attempt to elucidate the pathogenesis of DIS00pasteurellosis .	None
Two BAC00Nocardiopsis species, namely, BAC00N0_dassonvillei and BAC00N0_synnemataformans (among the thirty nine reported ones) are opportunistic human pathogens and cause DIS00mycetoma , suppurative DIS00infections and abscesses.	pathogen, cause
UNASSIGNED: BAC00Mycobacterium_bovis bacillus Calmette-Gu  rin ( BAC00M0_bovis_BCG ), the only currently available vaccine against DIS00tuberculosis , induces variable protection in adults.	vaccine
BACKGROUND:    Genotyping BAC00Mycobacterium_tuberculosis isolates allows study of dynamics of DIS00tuberculosis transmission, while geoprocessing allows spatial analysis of clinical and epidemiological data.	allow
BAC00Mycobacterium_tuberculosis isolates belonging to identical RFLP patterns (clusters) were considered to represent DIS00recent_tuberculosis_infection (cases).	represent
UNASSIGNED: BAC00Laribacter_hongkongensis is a potential emerging pathogen associated with community acquired DIS00gastroenteritis and traveler's DIS00diarrhea .	associate
UNASSIGNED: BAC00Acinetobacter_baumannii is an emerging nosocomial pathogen involved in a DIS00variety_of_infections ranging from minor soft-tissue DIS00infections to more severe DIS00infections such as DIS00ventilator0associated_pneumonia and DIS00bacteremia .	pathogen, involve
In this study, we focus on the potential role of the major high-affinity thrombin receptor, proteinase-activated receptor 1 (PAR-1), during the development of DIS00pneumonia to the common lung pathogen BAC00Streptococcus_pneumoniae .	pathogen
The distinction between the two species is extremely important given the different antibiotic susceptibility pattern and association of BAC00N0_pseudobrasiliensis with more invasive and disseminated DIS00disease .	association
The aim of this investigation has been to examine the response of intestinal epithelial cells to BAC00Enterococcus_faecium NCIMB 10415 ( BAC00E0_faecium ), a probiotic positively affecting DIS00diarrhea incidence in piglets, and two pathogenic BAC00Escherichia_coli ( BAC00E0_coli ) strains, with specific focus on the probiotic modulation of the response to the pathogenic challenge.	affect
BACKGROUND: Oral therapy for DIS00pulmonary_tuberculosis ( DIS00TB ) treatment suffers from the limitation of hepatic metabolism leading insufficient concentration of antitubercular (anti- DIS00TB ) drugs in alveolar macrophage which harbors BAC00Mycobacterium_tuberculosis ( DIS00MTB ).	None
The objective of this study was to determine the possibility of additional case detection for DIS00pulmonary_tuberculosis ( DIS00PTB ) by offering Xpert to smear-negative patients in a low-HIV burden setting with no BAC00Mycobacterium_tuberculosis (M.tb.) culture facilities.	None
The objective premises of the definition of BAC00H0_pylori as a potential limiting factor for assessing the quality of drinking water have been validated as follows: BAC00H0_pylori is an etiologic factor associated to the development of DIS00chronic_antral_gastritis , DIS00gastric_ulcer and DIS00duodenal_ulcer , and DIS00gastric_cancer either, in the Russian population the rate of DIS00infection with BAC00H0_pylori falls within range of 56 - 90%, water supply pathway now can be considered as a source of DIS00infection of the population with BAC00H0_pylori , the existence of WHO regulatory documents considering BAC00H0_pylori as a candidate for standardization of the quality of the drinking water quite common occurrence of biocorrosion, the reduction of sanitary water network reliability, that creates the possibility of concentrating BAC00H0_pylori in some areas of the water system and its delivery to the consumer of drinking water, and causes the necessity of the prevention of BAC00H0_pylori0associated gastric pathology of the population.	etiologic factor, associate
Bearing in mind the large economic losses due to, on the one hand, the prevalence of DIS00disease caused by BAC00H0_pylori , and, on the other hand, the biocorrosion of water supply system, the problem is both relevant in terms of communal hygiene and economy.	cause
UNASSIGNED: Background The prevalence of drug-resistant DIS00tuberculosis ( DIS00TB ) in Xinjiang is higher than in other regions of China, and Beijing/W lineage BAC00Mycobacterium_tuberculosis ( DIS00MTB ) is the dominant strain of DIS00MTB in Xinjiang.	strain
Although BAC00B0_cereus sensu lato levels in Korean fermented soybean products did not exceed the maximum levels permitted in South Korea (<10(4) CFU/g), these results indicate that the bacterial isolates have the potential to cause DIS00diarrheal_or_emetic_gastrointestinal_diseases .	cause
BAC00Cronobacter_sakazakii is an opportunistic pathogen associated with outbreaks of life-threatening DIS00necrotizing_enterocolitis , DIS00meningitis_and_sepsis in neonates and infants.	pathogen, associate
UNASSIGNED: BAC00Bacillus_anthracis , the causative agent of DIS00anthrax , is considered a high-priority agent that may be used in a food-related terrorist attack because it can be contracted by ingestion and it also forms spores with heat and chemical resistance.	causative agent
UNASSIGNED: BAC00Cronobacter_sakazakii is an emerging pathogen that causes severe and life-threatening conditions including DIS00meningitis , DIS00bacteremia , and DIS00necrotizing_enterocolitis .	pathogen, cause
Other mycobacteria that may be present in raw milk and may cause DIS00diseases are those belonging to the BAC00Mycobacterium_avium complex.	cause
UNASSIGNED: A 74-year-old female patient with DIS00end0stage_renal_disease , undergoing periodic hemodialysis, was hospitalized due to DIS00infection by multidrug-resistant BAC00Acinetobacter_baumannii after hip replacement surgery.	by
PURPOSE: Gastric colonization with BAC00Helicobacter_pylori ( BAC00H0_pylori ) has been implicated in the pathogenesis of DIS00pancreatic_cancer , but results of epidemiological studies have been inconclusive.	implicate
RESULTS: No overall association was observed between BAC00H0_pylori seropositivity and risk of DIS00pancreatic_cancer (OR 1.00; 95  % CI 0.74-1.35).	association
Nonsignificantly decreased DIS00pancreatic_cancer risk was observed with CagA seropositivity (OR 0.74; 95  % CI 0.48-1.15) and increased risk with CagA-negative BAC00H0_pylori seropositivity (OR 1.23; 95  % CI 0.83-1.82).	None
There was no significant overall association between BAC00H0_pylori seropositivity and DIS00pancreatic_cancer risk (OR 1.13; 95  % CI 0.86-1.50), but evidence of CagA strain-specific associations (OR 0.78; 95  % CI 0.67-0.91 and OR 1.30; 95  % CI 1.02-1.65 for CagA-positive and CagA-negative strains, respectively).	association
CONCLUSIONS: Our results provide further evidence for the existence of strain-specific associations between BAC00H0_pylori and DIS00pancreatic_cancer .	association
Most DIS00chronic_staphylococcal_infections in rabbits are caused by the ST121 lineage of BAC00Staphylococcus_aureus , although other less common lineages, such as ST96 can also be involved.	cause
UNASSIGNED: Numerous isolates of BAC00Flavobacterium_columnare were previously recovered from DIS00red_tilapia , Oreochromis sp., exhibiting DIS00columnaris0like_disease in Thai farms, and the phenotypic and genetic characteristics were described.	recover
It can be concluded from the present study that tuberculin testing is a useful method in studying the prevalence of DIS00disease as the PCR for BAC00Mycobacterium genus was positive in 92.5  %, BAC00M0_tuberculosis complex in 86.8  % and BAC00Mycobacterium_bovis in 77.4  % cases.	None
In this work, viruses such as DIS00hepatitis E virus, Japanese encephalitis virus, DIS00Influenza_virus_and_Nipah_virus , and bacteria such as BAC00Salmonella spp., Shiga toxin-producing BAC00Escherichia_coli , BAC00Campylobacter spp. and BAC00Leptospira spp. have been identified as the most prone to be transmitted from wild swine to humans on the basis of geographic spread in wild swine populations worldwide, pathogen circulation rates in wild swine populations, wild swine population trends in endemic areas, susceptibility of humans to DIS00infection , transmissibility from wild swine to humans and existing evidence of wild swine-human transmission events.	None
Two of the patients, undergoing peripheral blood allogeneic hematopoietic stem cell transplantation (alloHSCT) from human leukocyte antigen-identical sibling donors, died of DIS00pneumonia caused by C.  indologenes with or without BAC00Pseudomonas_aeruginosa .	cause
DIS00Group_B_streptococcus (GBS; BAC00Streptococcus_agalactiae ) are encapsulated gram-positive cocci belonging to Lancefield group B, that frequently colonizes the human genital and gastrointestinal tracts .	None
Complex interplays between BAC00P0_aeruginosa and other co-colonizing pathogens including BAC00Staphylococcus_aureus , BAC00Burkholderia_sp0 , and BAC00Klebsiella_pneumoniae may be crucial for pathogenesis and DIS00disease progression.	crucial
Initially, BAC00L0_reuteri was used in humans to reduce the incidence and the severity of DIS00diarrhea , prevent colic and DIS00necrotic_enterocolitis , and maintain a functional mucosal barrier.	reduce
CONCLUSION: Analysis of recent nationwide studies revealed BAC00V0_cholerae was the most common bacterial/parasitic agent of DIS00diarrhea across all populations, being followed by DIS00diarrhea genic BAC00E0_coli and DIS00Giardia_intestinalis .	agent
Presumptive acute DIS00brucellosis due to BAC00B0_abortus was identified among 26 (7.0%) of patients while BAC00B0_melitensis was detected in 57 (15.4%) of the enrolled patients.	due
The test-and-treat strategy for detecting BAC00H0_pylori is appropriate in situations where the risk of DIS00gastric_cancer is low based on age younger than 55 years and the absence of alarm symptoms.	appropriate
UNASSIGNED: Arbutin induced suppression of DIS00angular_leaf_spot_disease in cucumber resulting from lower populations of BAC00Pseudomonas_syringae pv lachrymans in the infected tissues.	result
METHODS: BAC00H0_pylori status was reviewed in 154 patients with DIS00celiac_disease or DIS00duodenal_intraepithelial_lymphocytosis and in a control population.	reviewed
RESULTS: BAC00H0_pylori prevalence was 36% in DIS00celiac_disease patients, 19% in case of duodenal DIS00intraepithelial_lymphocytosis and 41% in controls (P<0.05 vs. duodenal DIS00intraepithelial_lymphocytosis ).	in
BAC00H0_pylori prevalence was not significantly different between DIS00celiac_disease patients with or without iron DIS00deficiency_anemia (22% vs. 39%) and it was higher in patients with milder DIS00duodenal_lesions : 50% in Marsh-Oberhuber classification type 1-2 vs. 33% in type 3.	significantly
CONCLUSION: BAC00H0_pylori prevalence was similar in DIS00celiac_disease patients and in controls and higher in patients with milder DIS00duodenal_lesions .	prevalence
The presence of BAC00H0_pylori was examined in the surgical specimens of 88 patients (41 females and 47 males; age range 6-70 years, mean age 32.5    14.8 years), including 35 patients with TS, 22 patients with DIS00cholesteatoma , 20 patients with CSOM, and 11 patients with DIS00otosclerosis .	examine
Tympanosclerotic plaques and control specimens from the DIS00cholesteatoma , polypoid mucosa, or mucosal portion of the perforations and stapes supra structure were examined for the presence of BAC00H0_pylori and/or BAC00C0_pneumoniae using real-time polymerase chain reaction analysis.	None
The enterohemorrhagic BAC00Escherichia_coli_O1570H7 is a frequent and potent foodborne pathogen that causes severe DIS00disease in humans.	pathogen, cause
BACKGROUND: BAC00Mycoplasma_pneumoniae ( BAC00M0_pneumoniae ) is an important pathogen of community-acquired DIS00pneumonia in children, but the epidemiology and clinical features of DIS00M0_pneumoniae_infection in infants are reported in only a few studies.	pathogen
Such responses are important for the protection against DIS00diseases caused by intracellular bacteria such as BAC00Chlamydia_trachomatis and BAC00Mycobacterium_tuberculosis .	cause
DIS00Canine_monocytic_ehrlichiosis (CME), caused by BAC00Ehrlichia_canis , is a vector-borne DIS00disease with a worldwide distribution.	cause
UNASSIGNED: The main goal of this study was to develop an improved oral delivery system for BAC00Pediococcus_pentosaceus OZF, a promising probiotic BAC00bacterium , and to assess its viability under simulated gastrointestinal ( DIS00GI ) tract model by comparing the efficiency of microbiological and molecular approaches.	None
It is well established that a healthy gut microbiota provides its host with protection from numerous pathogens, including BAC00Salmonella species, BAC00Clostridium_difficile , DIS00diarrheagenic_Escherichia_coli , and BAC00Vibrio_cholerae .	None
Based on the 10 years data (1992-2001) from China, DIS00gastroenteritis caused by BAC00Vibrio_parahaemolyticus accounted for 31.1% of DIS00foodborne_disease outbreaks that were resulted from microorganisms.	cause
OBJECTIVE: The aim of this study was to express BAC00Mycobacterium_tuberculosis MPT83 protein and to evaluate its immunogenicity in murine model as well as the serological diagnosis potential value for bovine DIS00tuberculosis .	None
Our research objectives were to determine if (1) fin clips, gill snips, surface mucus scrapings, blood draws, or kidney biopsies could be obtained non-lethally from 3 to 15 g DIS00Chinook_salmon_Oncorhynchus_tshawytscha , (2) non-lethal samples could accurately discriminate between fish exposed to the DIS00bacterial_kidney_disease agent BAC00Renibacterium_salmoninarum and non-exposed fish, and (3) non-lethal samples could serve as proxies for lethal kidney samples to assess DIS00infection intensity.	agent
Given the high levels of BAC00C0_burnetii exposure in marine mammals distributed throughout the same geographic range as the northern sea otter, and the presence of DIS00valvular_lesions seen in otters, the objective of this study was to determine the level of BAC00C0_burnetii exposure in otters and investigate any association between exposure, DIS00infection and DIS00valvular_disease in this species.	None
Ribosomal RNA of BAC00Propionibacterium_acnes and BAC00P0_granulosum was measured by real-time quantitative reverse transcription-polymerase chain reaction (RT-PCR) using formalin-fixed and paraffin-embedded tissue of lymph node biopsy from 65 Chinese patients with DIS00sarcoidosis , 45 with DIS00tuberculosis and 50 controls with other DIS00diseases (23 with non-specific DIS00lymphadenitis and 27 with mediastinal lymph node metastasis from DIS00lung_cancer ).	None
UNASSIGNED: DIS00Tuberculosis remains one of the world's deadliest human DIS00diseases , with a high prevalence of antibiotic-resistant BAC00Mycobacterium_tuberculosis ( DIS00Mtb ) strains.	prevalence
A murine DIS00sporotrichosis model showed that a BAC00S0_brasiliensis strain with high expression of virulence factors was able to disseminate and yield a high fungal burden in comparison with a control S. schenckii strain.	show
DIS00Tuberculosis ( DIS00TB ) is a DIS00chronic_infectious_disease , considered as the second leading cause of DIS00death worldwide, caused by BAC00Mycobacterium_tuberculosis .	cause
Distributions for model parameters (e.g., release quantity of BAC00B0_anthracis spores, risk of illness, spore setting velocity, resuspension rate, sample recovery efficiency, etc.) were updated by comparing model predictions with measurements of BAC00B0_anthracis spores made after one of the 2001 DIS00anthrax letter attacks.	after
Although drugs are subjected to much more severe testing and regulation procedures before reaching the market, they might contain exactly the same active ingredient as certain agrochemicals, what is the case described in present work, showing how a small chemical compound might be used to control pathogenicity of Gram negative bacteria BAC00Xylella_fastidiosa which devastates citrus plantations, as well as for control of, for example, DIS00meningitis in humans.	devastates
Diverse BAC00Streptococcus species including BAC00Streptococcus Pneumoniae, Sanguis, Gordonii, DIS00Mitis and Mutans cause life-threatening conditions including DIS00pneumonia , DIS00bacteremia_and_meningitis .	cause
All together, these results underline the promising scope of HM-based macromolecular ligands for the antiadhesive treatment of BAC00E0_coli induced DIS00inflammatory_bowel_diseases .	induce
Much of the DIS00disease burden can be avoided by immunization, particularly against BAC00Haemophilus_influenzae type b (Hib) and BAC00Streptococcus_pneumoniae .	avoid
It was previously demonstrated that the administration of milk fermented by BAC00Lactobacillus_casei CRL 431 [fermented milk (FM)] delayed the DIS00tumor growth in a murine DIS00breast_cancer model.	delay
At present, BAC00Mycobacterium_bovis_Bacillus Calmette Guerin (BCG) is the singular anti  -TB vaccine available for the prevention of DIS00disease in humans; however, this vaccine only provides limited protection against DIS00Mycobacterium_tuberculosis_0Mtb0_infection .	vaccine, prevention
Employing a novel medium designed to mimic the chemical composition of human serum, we show here that BAC00Bacillus_anthracis , the causative agent of DIS00anthrax_disease , proteolyzes human hemoglobin to liberate essential amino acids which enhance its growth.	causative agent
Removing essential amino acids from BSM revealed that two of the most abundant proteins in blood - hemoglobin and serum albumin - can satiate the amino acid requirement for BAC00Bacillus_anthracis , the causative agent of DIS00anthrax .	causative agent
UNASSIGNED: BAC00Salmonella_enterica_subspecies_enterica_serovar_Typhimurium ( BAC00S0_Typhimurium ) is one of the most prevalent serovars in Europe - where both poultry and poultry related products are common sources of human DIS00salmonellosis . Due to efficient control programs, the prevalence of BAC00S0_Typhimurium in Danish poultry production is very low.	None
UNASSIGNED: BAC00Escherichia_coli of the O157 serogroup are comprised of a diverse collection of more than 100 O157:non-H7 serotypes that are found in the environment, animal reservoir, and infected patients and some have been linked to severe outbreaks of human DIS00disease .	link
Among these, the enteropathogenic BAC00E0_coli_O1570non0H7 serotypes carry virulence factors that are hallmarks of enterohemorrhagic BAC00E0_coli , such as causing attaching and effacing lesions during human DIS00gastrointestinal_tract_infections .	cause
BACKGROUND: DIS00Typhoid_fever is an acute, invasive, and potentially fatal DIS00systemic_infection caused by BAC00Salmonella_enterica subspecies enterica serotype Typhi (S. Typhi).	cause
UNASSIGNED: BAC00Staphylococcus_aureus ( BAC00S0_aureus ) is an important human pathogen that causes several DIS00diseases ranging from DIS00superficial_skin_infections to life-threatening DIS00diseases .	pathogen, cause
UNASSIGNED: The leading risk factor for DIS00gastric_cancer in humans is DIS00infection by BAC00Helicobacter_pylori strains that express and translocate the oncoprotein CagA into host epithelial cells.	by
BACKGROUND: DIS00Listeriosis , mostly caused by BAC00Listeria_monocytogenes_species, has become a major concern to public health authorities due to its clinical severity and high mortality rate, particularly in high risk groups.	cause
However, severe DIS00sepsis can occur after TRUS prostate biopsies, with BAC00Escherichia_coli being the predominant causative agent.	agent
METHODS: We compared BAC00E0_coli isolates from male patients with DIS00bacteremic_urinary_tract_infection ( DIS00B0UTI ) to isolates of patients with DIS00post_prostate_biopsy_sepsis ( DIS00PPBS ), in terms of their sequence types, determined by multi-locus sequence typing (MLST) and their virulence markers.	isolate
BAC00Staphylococcus_aureus that produce PVL are responsible for severe DIS00diseases , including DIS00necrotizing_pneumonia .	responsible
SIGNIFICANCE AND IMPACT OF THE STUDY: Panton-Valentine leukocidin (PVL) is a pore-forming toxin produced by BAC00Staphylococcus_aureus , responsible for neutrophil damage and key player of severe DIS00staphylococcal_diseases .	responsible
UNASSIGNED: The fluoroquinolone moxifloxacin has potent activity against BAC00Mycobacterium_tuberculosis and has been recommended by the guidelines for the treatment of DIS00pulmonary_tuberculosis ( DIS00TB ).	None
UNASSIGNED: Between 2010 and 2014, we obtained swab specimens to detect BAC00Treponema_pallidum , with PCR assays, from the oral cavities of 240 patients with 267 episodes of DIS00syphilis who reported engaging in unprotected sex practices.	from
UNASSIGNED: BAC00Neisseria_meningitidis can cause severe and fulminant DIS00diseases such as DIS00meningitis . DIS00Meningococcal_capsular_polysaccharide (PS) is a key virulence determinant that is not able to induce immunological memory.	cause
During an inflammatory response in the gut, some commensal bacteria such as BAC00E0_coli can thrive and contribute to DIS00disease .	contribute
These findings define a fundamental mechanism by which BAC00E0_coli surpasses the host innate immune responses during inflammatory gut DIS00diseases and gains a distinct survival advantage.	response
The BAC00V0_antiquarius genome encodes genes and operons with ecological functions relevant to the environment conditions of the deep sea and also harbors factors known to be involved in human DIS00disease caused by freshwater, coastal, and brackish water vibrios.	factor
BAC00Xanthomonas_albilineans causes leaf scald, a lethal DIS00disease of sugarcane. Compared to other species of BAC00Xanthomonas , BAC00X0_albilineans exhibits distinctive pathogenic mechanisms, ecology and taxonomy.	cause
BACKGROUND: BAC00Neisseria_lactamica as one of the main commensal in oropharynx during the childhood is related to the induction of a natural immunity against DIS00meningococcal_meningitis .	relate, against
FTIR analysis was performed to assess the chemical linkages, and antimicrobial assays were performed with two strains: BAC00Staphylococcus_aureus (Gram-positive BAC00bacterium ) and DIS00Klebsiella_pneumonia (Gram-negative BAC00bacterium ).	None
UNASSIGNED: The BAC00Bordetella_pertussis polymerase chain reaction positivity rate changed after additional DIS00diphtheria - DIS00tetanus -acellular DIS00pertussis boosters in 2005 and 2008, 9.8%, 13.4%, 22% and 15.2% in 2010, 2011, 2012 and 2013, P < 0.001, respectively.	change
CagA-positive BAC00H0_pylori is associated with an increased risk for DIS00gastric_cancer compared with negative strains.	associate
The Lyme DIS00disease spirochete BAC00Borrelia_burgdorferi migrates to distant sites in the tick vectors and mammalian hosts through robust motility and chemotaxis activities.	None
In this article, we studied how two proteins, called FliH and FliI, are important for the production of full-length flagella in the Lyme DIS00disease spirochete BAC00Borrelia_burgdorferi .	None