BACKGROUND : BAC00Escherichia_coli ( BAC00E0_coli ) strains , expressing S-fimbriae , belong to the most common_gram-negative_pathogens that cause DIS00sepsis and DIS00meningitis in neonates .	pathogen, cause
In addition , among the extracellular_products , those which have cytotoxic_activity to Vero cells may contribute to the lethality in DIS00sepsis caused by BAC00S0_aureus in this murine_model .	cause
BAC00Streptococcus_pneumoniae , the pneumococcus , is the most common_cause of DIS00sepsis and DIS00meningitis .	common_cause
Cyclophosphamide was then administered to induce DIS00leukopenia and translocation of the BAC00P0_aeruginosa that had colonized the gastrointestinal_tract , thereby producing gut-derived generalized DIS00sepsis .	None
Our results indicate that antiflagellar_human_monoclonal_antibody SC-1225 protects mice against DIS00gut-derived_sepsis caused by BAC00P0_aeruginosa and suggest that such an effect is due to its opsonophagocytic_activity and the reduced motility of the translocated bacteria once the bacteria move from the intestine into the bloodstream .	cause
The study shows a high_prevalence of DIS00neonatal_bacterial_sepsis at the centre and the emerging role of BAC00Listeria_monocytogenes in the aetiology of DIS00neonatal_sepsis .	None
The effect of passive immunotherapy with antisera against BAC00heat-killed_Pseudomonas_aeruginosa and three of its exo-enzymes ( elastase , alkaline protease and exotoxin A ) in DIS00gut-derived_P0_aeruginosa_sepsis was evaluated .	None
Cyclophosphamide was then administered to induce translocation of BAC00P0_aeruginosa that had colonised the gastrointestinal_tract so that DIS00gut-derived_septicaemia was produced .	None
These results indicate that passive_immunisation with antiserum against heat-killed_bacteria and exotoxin A , but not with antiserum against either elastase or alkaline protease , protects mice against DIS00gut-derived_sepsis caused by BAC00P0_aeruginosa .	cause
Of the organisms encountered , BAC00Staphylococcus_aureus was the most frequently occurring organism ( 39 % ) , followed by coliform BAC00bacilli ( 24 % ) , which was the most prevalent_organism ( 44 % ) in DIS00post-operative_sepsis .	None
BACKGROUND : To evaluate clinical and microbiological_characteristics of DIS00sepsis due to BAC00Corynebacterium_amycolatum , because few_cases have been reported in DIS00human_infections by this bacteria .	due
METHODS : We report two cases of DIS00sepsis due to BAC00Corynebacterium_amycolatum , the patients were diagnosed as having DIS00leukaemia .	due
To evaluate the protective_effect of trovafloxacin , ciprofloxacin and ampicillin against penicillin-susceptible , - intermediate and - resistant_strains of BAC00Streptococcus_pneumoniae , an intraperitoneal , immunocompetent_mouse model of DIS00sepsis was used .	None
Norepinephrine stimulates growth of BAC00Escherichia_coli , BAC00Yersinia_enterocolitica , and BAC00Pseudomonas_aeruginosa in serum-supplemented_media , and in vivo increases in norepinephrine may be important in the pathogenesis of DIS00sepsis by gram-negative_bacteria .	None
The significant_resistance to antibiotics was present in 47 % of DIS00Gram-negative_sepsis ( causative_microorganisms were BAC00Pseudomonas_aeruginosa and BAC00Acinetobacter species ) and in 18 % of DIS00Gram-positive_sepsis ( susceptibility to imipenem only in DIS00Gram-negative_sepsis and susceptibility to vankomycin in DIS00Gram-positive_sepsis ) .	causative_microorganisms
BACKGROUND : BAC00Klebsiella_pneumoniae is a major_cause of DIS00neonatal_sepsis_and_nosocomial_infections in Mexico .	cause
BAC00Yersinia_enterocolitica accounts for 50 % of the DIS00clinical_sepsis episodes caused by the transfusion of contaminated red_blood cells .	account
Counts of inoculated BAC00E0_coli and translocated bacteria in different_locations , gut morphology and haematological_values were evaluated at different_stages of DIS00sepsis .	None
In DIS00early_sepsis , translocation was associated with BAC00high_E0_coli counts in blood , yet in DIS00late_sepsis the opposite_correlation was present .	associate, opposite_correlation
CONCLUSIONS : BAC00P0_aeruginosa may act as a pathogen in the gastrointestinal_tract , resulting in altered_epithelial_barrier function and DIS00death in a susceptible_host .	result
One patient had DIS00catheter-related_sepsis with BAC00Staphylococcus_aureus .	with
Also , whereas NE0deficient_mice had impaired_survival in response to DIS00E0_coli_sepsis , as compared to wild-type_mice , the presence or absence of NE had no influence on survival in response to DIS00sepsis that had been induced with BAC00OmpA-deficient_E0_coli .	induce
The immunotherapies were developed in the late_1960s and put into widespread_use in the Soviet Union for the prophylaxis and treatment of DIS00sepsis , DIS00pneumonia , and other_conditions caused by an epidemic of BAC00antibiotic-resistant_Staphylococcus_aureus .	cause
The common_pathogens were BAC00Escherichia_coli ( 57 % ) , BAC00Enterococcus ( 27 % ) , DIS00Klebsiella_pneumonia ( 18 % ) , BAC00Morganella_morganii ( 7.6 % ) , BAC00Pseudomonas_aeruginosa ( 4.1 % ) and BAC00Salmonella ( 0.7 % ) .	None
Coagulase BAC00negative_Staphylococcus ( CONS ) ( 50 % ) was the most common infecting organism causing late_onset DIS00sepsis ( LOS ) and BAC00Escherichia_coli ( 29 % ) the most common causing early_onset DIS00sepsis ( EOS ) .	cause
The DIS00primary_disease was DIS00sepsis in these three patients ; BAC00S0_aureus was cultured from blood in two patients and Gram-positive_cocci was observed following examination of the joint_fluid in the other_patient .	None
By using a similar_experimental_setup , DIS00severe_hyperdynamic_sepsis was induced ( n = 15 ) by intravenous_infusion of BAC00live_Escherichia_coli ( 2 x 10 ( 9 ) colony-forming_units/kg ) over 2 hrs , followed by antibiotic_therapy ( gentamicin 4 mg/kg twice a day ) .	induce
MEASUREMENTS AND MAIN RESULTS : Plasma PCT at baseline was barely detectable , but levels increased significantly ( p < .05 ) to 2 + / -1.8 pg/mL 2 hrs after the start of reperfusion in the shock group , and to 987 + / -230 pg/mL at 4 hrs after BAC00E0_coli in the DIS00sepsis group .	in
PCT levels were approximately three times higher in the DIS00sepsis group than in the shock group , corresponding to endotoxin levels ( at the end of DIS00hemorrhage , 286 + / -144 pg/mL vs. 3576 + / -979 pg/mL at the end of BAC00E0_coli infusion ; p = .003 ) .	None
OBJECTIVE : To determine whether low `` stretch '' mechanical_ventilation protects animals from DIS00clinical_sepsis after DIS00direct_acute_lung_injury with BAC00Pseudomonas_aeruginosa as compared with high `` stretch '' ventilation .	with
OBJECTIVE : Report of 8 cases of disseminated DIS00infection with BAC00V0_vulnificus causing DIS00fulminant_sepsis . DESIGN : Series of cases .	cause
Notably , blockade of TREM-1 protects mice against DIS00LPS0induced_shock , as well as DIS00microbial_sepsis caused by BAC00live_Escherichia_coli or caecal_ligation and puncture .	cause
BAC00Streptococcus_agalactiae ( group B BAC00streptococcus , BAC00GBS ) is the major_pathogen of DIS00neonatal_sepsis .	major_pathogen
To determine the role of endogenous_IL-10 in local_antibacterial_host defense and in the development of a DIS00systemic_inflammatory_response_syndrome during DIS00abdominal_sepsis , IL-10 gene-deficient ( IL-10 ( - / - ) ) and wild-type ( IL-10 ( + / + ) ) mice received an i.p. injection with BAC00Escherichia_coli .	None
The results suggest that activation of the contact system at the surface of BAC00S0_aureus and the subsequent_release of bradykinin could contribute to the DIS00hypovolemic_hypotension seen in patients with DIS00severe_S0_aureus_sepsis .	contribute
Antibiotic-resistant_bacteria include the BAC00enteric_gram-negative_bacilli , especially BAC00Escherichia_coli , BAC00Klebsiella and BAC00Enterobacter , and BAC00Haemophilus_influenzae type b , a major_respiratory_tract pathogen and cause of DIS00meningitis .	pathogen, cause
During the last_few_years , there has been an increased number of case reports claiming an association of BAC00C0_xerosis with DIS00diseases , like DIS00septicemia , DIS00endocarditis , DIS00pleuropneumonia , DIS00peritonitis , DIS00osteomyelitis , DIS00septic_arthritis , DIS00mediastinitis , DIS00meningitis , DIS00ventriculitis specially in immunocompromised_patients or surgical_patients .	association
We report a case of DIS00sepsis due to BAC00C0_xerosis in a newborn without DIS00evident_immunodeficiency .	due
DIS00Severe_hyperdynamic_sepsis was induced in baboons ( n = 14 ) by i.v. infusion of BAC00live_E0_coli ( approximately 2 x 10 ( 9 ) colony-forming_units/kg ) over 2 h. Animals were pretreated 2 h before BAC00E0_coli either with 1 mg/kg humanized anti-TNF_antibody ( CDP571 ) or placebo ( Ringer solution ) .	induce
To determine the relative_contribution of lipopolysaccharide ( LPS ) and non-LPS_components of BAC00Neisseria_meningitidis to the pathogenesis of DIS00meningococcal_sepsis , this study quantitatively compared cytokine induction by isolated LPS , wild-type_serogroup B meningococci ( strain H44/76 ) , and DIS00LPS0deficient mutant_meningococci ( strain H44/76 -LSB- pLAK33 -RSB- ) .	pathogenesis
The principal_conclusion is that non-LPS_parts of BAC00N0_meningitidis may play a role in the pathogenesis of DIS00meningococcal_sepsis by inducing substantial_TNF-alpha , IL-1beta , and IFN-gamma production .	pathogenesis
Plasma was collected from thermally injured rats with BAC00E0_coli O18 DIS00sepsis and filtered . DIS00LPS was affinity-purified from plasma filtrates using monoclonal_antibody specific for the O-polysaccharide_side chain of BAC00E0_coli O18 DIS00LPS .	None
DIS00Blood0brain_barrier ( BBB ) permeability during DIS00sepsis with BAC00Escherichia_coli or BAC00Streptococcus_pneumoniae was examined in a mouse model and measured by a circulating beta-galactosidase tracer .	with
A model of ALI was used in which adult_baboons were primed with killed BAC00Escherichia_coli ( 1 x 10 ( 9 ) CFU/kg ) , and DIS00bacteremic_sepsis was induced 12 h later by infusion of BAC00live_E0_coli at 1 x 10 ( 10 ) CFU/kg .	induce
Recombinant_MIF was found to exacerbate DIS00lethal_endotoxemia or DIS00bacterial_sepsis when co-injected with DIS00LPS or BAC00Escherichia_coli in mice .	co-injected
BAC00Streptococcus_pyogenes causes DIS00severe_invasive_diseases in humans , including DIS00necrotizing_fasciitis , DIS00sepsis , and DIS00streptococcal_toxic_shock_syndrome ( DIS00STSS ) .	cause
In addition , a human_clinical_isolate of BAC00P0_aeruginosa , strain PA14 , also causes DIS00disease in a variety of nonvertebrate_hosts , including plants , Caenorhabditis elegans , and the greater wax moth , Galleria mellonella .	cause
Mutation of the ybtQ homolog in BAC00P0_aeruginosa strain PA14 significantly attenuates the virulence of this strain in both G. mellonella and a burned_mouse model of DIS00sepsis to levels comparable to those seen with PAO1 .	None
BAC00Streptococcus_pneumoniae is an important_cause of upper and lower DIS00respiratory_tract_infections , DIS00meningitis , DIS00peritonitis , DIS00bacterial_arthritis , and DIS00sepsis .	important_cause
BAC00Streptococcus_pneumoniae is the commonest infecting organism , accounting for 50-90 % of isolates from blood cultures in reported series ; it is particularly common in children with DIS00sickle_cell_disease .	with
BAC00Streptococcus_suis capsular_type 2 is an important_aetiologic_agent of DIS00swine_meningitis , and it has been highlighted as a cause of DIS00occupational_disease leading to DIS00meningitis and DIS00fulminant_sepsis in humans .	important_aetiologic_agent
Mice infected with the BAC00gram-negative_bacterium_Salmonella_enterica serovar Typhimurium exhibit marked_genetic_differences in DIS00disease manifestation , and the wild-derived_strain Mus musculus molossinus MOLF/Ei is extremely susceptible to BAC00S0_enterica serovar Typhimurium .	in
IL-1R-deficient_mice ( IL-1R ( - / - ) ) and their wild-type_controls ( IL-1R ( + / + ) ) were i.v. inoculated with 1 x 10 ( 7 ) or 10 ( 6 ) BAC00Staphylococcus_aureus per mouse to mimic DIS00bacterial_sepsis and DIS00septic_arthritis .	None
BAC00Staphylococcus_aureus is one of the most significant_pathogens in DIS00human_sepsis and DIS00endocarditis .	significant_pathogens
BAC00S0_aureus can initiate DIS00blood_coagulation , leading to the formation of microthrombi and DIS00multiorgan_dysfunction in DIS00sepsis , whereas in DIS00endocarditis the BAC00bacterium induces fibrin_clots on the inner_surface of the heart , so-called_endocardial_vegetations .	initiate
DIS00Sepsis induced by BAC00S0_aureus was used to investigate whether neutrophil DIS00migration_failure to infectious_focus correlates with lethality in DIS00Gram-positive_bacteria-induced_sepsis in mice .	induce
Early DIS00sepsis occurs during the first_week and presents in the form of frank_clinical_features ( DIS00pain , DIS00erythema , DIS00penile_discharge ) ; highly virulent_bacteria are isolated , such as BAC00Staphylococcus_aureus .	isolate
Late DIS00sepsis occurs after an interval of several_weeks to several_months with less specific_clinical_features ; BAC00Staphylococcus_epidermidis is isolated in more than 50 % of cases .	isolate
CONCLUSION : BAC00Supplementary_L0_plantarum 299 was effective in reducing DIS00pancreatic_sepsis and the number of surgical_interventions .	effective, reduce
For DIS00gallstone_diseases , the most common_organisms cultured were Gram negative_bacteria ( 74 % ) , in which BAC00Escherichia_coli ( 36 % ) and BAC00Klebsiella ( 15 % ) were most commonly found , followed by Gram positive ( 15 % ) bacteria such as BAC00Enterococcus ( 6 % ) , Staphylcoccus ( 3 % ) , BAC00Streptococcus ( 2 % ) .	None
-- In one boy OIPD was discovered at the age of 7 weeks following treatment first for DIS00neonatal_sepsis and then for DIS00urinary_infection , both caused by the same_phage type of BAC00Staphylococcus_aureus .	cause
RWJ-54428 was effective in vivo against methicillin-susceptible and - BAC00resistant_S0_aureus in a mouse model of DIS00sepsis , with 50 % effective_doses being similar to those of vancomycin .	None
In a mouse model of DIS00pneumonia due to a penicillin-susceptible_strain of BAC00Streptococcus_pneumoniae , RWJ-54428 displayed efficacy and potency superior to those of penicillin G and cefotaxime .	due
OBJECTIVE : To investigate the protective_effect and its underlying_mechanism of 2,4-diamino-6-hydroxy-pyrimidine ( DAHP ) , an inhibitor of DIS00GTP0cyclohydrolase_I ( GTP-CHI ) , on BAC00postburn_Staphylococcus_aureus ( BAC00S0_aureus ) DIS00sepsis in rats .	None
To further assess the role of BAK in DIS00sepsis in DIS00acute_renal_failure , dogs were nephrectomized and 48 h later administered intraperitoneally with 30 x 10 ( 10 ) bacteria/kg of BAC00E0_coli .	None
BACKGROUND : BAC00Yersinia_enterocolitica , BAC00Pseudomonas_fluorescens , and BAC00P0_putida are responsible for a significant_amount of the DIS00bacterial_sepsis cases attributed to RBC transfusions .	responsible
BAC00Pseudomonas_aeruginosa is a pathogen that frequently causes DIS00acute_lung_injury , DIS00bacteremia and DIS00sepsis in critically ill_patients .	cause
One week later , he was admitted to our hospital and was subsequently diagnosed with DIS00sepsis associated with four species of bacteria ( BAC00Streptococcus_constellatus , BAC00Fusobacterium_mortiferum , BAC00Bacteroides_thetaiotaomicron , and BAC00non-spore-forming_anaerobic_gram-positive_bacillus ) .	associate
The two leading causes of DIS00bacterial_pneumonia in childhood are BAC00Streptococcus_pneumoniae ( SP ) and BAC00Haemophilus_influenzae type b ( Hib ) .	cause
BAC00Extraintestinal_Escherichia_coli strains cause DIS00meningitis , DIS00sepsis , DIS00urinary_tract_infection , and DIS00other_infections outside the bowel .	cause
METHODS : Patients with DIS00acute_pancreatitis , arriving within 48 hours after onset of DIS00disease showing typical_clinical_picture and laboratory signs of DIS00pancreatitis ( plasma amylase > 200 U/l , CRP > 150 mg/l and an Imrie-score = or > 3 ) were randomised into two groups During the first_week the treatment group received a freeze-dried_preparation containing 10 ( 9 ) live BAC00Lactobacillus_plantarum 299 together with an oat fibre substrate .	None
CONCLUSIONS : Supplementing BAC00Lactobacillus_plantarum 299 is an effective_tool to prevent DIS00pancreatic_sepsis , to reduce the number of operations and length of stay .	prevent
INTERVENTIONS : Mice were subjected to intratracheal_injection of BAC00Pseudomonas_aeruginosa and killed between 1.5 and 24 hrs after induction of DIS00pneumonia-induced_sepsis to assess for gut epithelial_proliferation and cell division and for apoptosis .	None
In contrast , cells in M-phase remained constant for the first 12 hrs after the onset of DIS00sepsis , but increased nearly 50 % at 24 hrs after instillation of BAC00P0_aeruginosa ( p < .005 ) .	None
CONCLUSION : Antibody to TNF improved host defense and survival rates with both BAC00lethal_E0_coli and DIS00S0_aureus_pneumonia , but protection was greater with BAC00E0_coli , where TNF concentrations were higher than with BAC00S0_aureus .	None
RESULTS : The counts of BAC00E0_coli were the highest in the organs and blood 6 h after the onset of DIS00sepsis , being in correlation with the highest counts of apoptotic_cells in the liver and the falling counts of activated macrophages .	highest
A low_incidence of nasal_carriage of BAC00S0_aureus isolates correlated with low_incidence of wound DIS00sepsis .	correlate
The human-specific_bacterial_pathogen BAC00Neisseria_meningitidis is a major_cause of DIS00sepsis and/or DIS00meningitis .	major_cause
In a subgroup of patients with DIS00severe_sepsis or DIS00septic_shock , caused by other_bacteria than BAC00Neisseria_meningitidis , the M/F-ratio was 2.1 ( 1.2 ; 3.6 ) ( Chi2 = 4.9 ; P < 0.05 ) , while in patients with DIS00meningococcal_sepsis ( n = 20 ) the M/F-ratio was 1.0 ( 0.4 ; 2.3 ) .	cause
Out of 233 positive_blood cultures BAC00Escherichia_coli was found to be commonest ( 47.8 % , n = 111 , p < 0.05 ) both in early_onset ( 47.8 % , n = 68 , p < 0.05 ) and late_onset DIS00sepsis ( 47.3 % , n = 43 , p < 0.05 ) .	in
BAC00Streptococcus_agalactiae is the leading cause of DIS00bacterial_sepsis and DIS00meningitis in neonates and also the causative_agent of DIS00different_serious_infections in immunocompromised_adults .	cause, causative_agent
The wide_range of DIS00diseases that are caused by BAC00S0_agalactiae suggests regulatory_mechanisms that control the formation of specific_virulence factors in these bacteria .	cause
BAC00Staphylococcus_epidermidis is the most frequent_cause of DIS00nosocomial_sepsis and DIS00catheter-related_infections , in which biofilm formation is considered to be the main_virulence mechanism .	frequent_cause
S-fimbriae are a common_property of BAC00E0_coli strains causing DIS00sepsis and DIS00meningitis in neonates .	cause
S fimbriae are a common_feature of BAC00E0_coli strains causing DIS00sepsis and DIS00meningitis in newborns and are bound to epithelia via sialyl - ( alpha-2-3 ) galactoside structures .	cause
BAC00Streptococcus_suis is a common_cause of DIS00sepsis , DIS00meningitis , and DIS00other_serious_infections in young_piglets and also causes DIS00meningitis in humans .	common_cause
An experimental_model for DIS00intra0abdominal_sepsis was created with implantation of gelatin capsules , containing 3 x 10 ( 8 ) cfu BAC00E0_coli strain no. 2554 , in the peritoneal_cavity of 20 rats ( 10 animals received and 10 did not receive antibiotic_therapy with ceftriaxone ) in order to verify the role of the primary_site of DIS00infection in the pathogenesis of DIS00pneumonia .	None
Virulence factors ( serogroup , DIS00haemolysis , haemagglutination , antigens K1 , K5 , colicinogenicity ) and their association with DIS00diseases of 3334 BAC00Escherichia_coli strains isolated from different_clinical_specimens between 1979-1990 were analysed .	None
RESULTS : Eleven of the 20 patients had bacteriologically documented DIS00infections : four with DIS00meningitis and two with DIS00bacteremia caused by BAC00Neisseria_meningitidis , three with DIS00meningitis caused by BAC00Haemophilus_influenzae type b , and one each with DIS00meningitis_and_bacteremia caused by BAC00Streptococcus_pneumoniae .	cause
BAC00Streptococcus_pneumoniae is a leading cause of DIS00gram-positive_sepsis , and lipoteichoic_acid ( LTA ) may be important in causing DIS00gram-positive_bacterial_septic_shock .	cause
We investigated plasma proinflammatory_cytokine profiles in patients with DIS00sepsis due to gram-positive and gram-negative_bacteria and studied the cytokine production and differential_gene regulation of leukocytes stimulated ex vivo with BAC00Escherichia_coli lipopolysaccharide or BAC00heat-killed_Staphylococcus_aureus .	None
Sixteen years after transplant , she presented with DIS00Gram-negative_sepsis with BAC00Proteus_mirabilis and DIS00acute_anuric_renal_failure in the allograft .	with
RESULTS : The etiological_agents more frequently found are BAC00Streptococcus_pneumoniae , DIS00Haemophilus_influenza_and_type_B , and BAC00Neisseria_meningitidis .	None
BAC00Listeria_monocytogenes is the causative_agent of DIS00infections_like_sepsis and DIS00meningitis , especially in immunocompromised_hosts .	causative_agent
Furthermore , a single_infusion of MAb 12-9 was protective against an intravenous_challenge with a methicillin-resistant_strain of BAC00S0_aureus in a DIS00murine_sepsis model ( P < 0.0001 ) .	in
BACKGROUND : BAC00Staphylococcus_aureus is one of the most common_bacteria in DIS00human_sepsis , a condition in which the activation of DIS00blood_coagulation plays a critical_pathophysiological_role .	common_bacteria
These signals may explain the potent_effects of BAC00N0_meningitidis on CD62E expression on vascular_endothelium and provide a basis for the complex DIS00endothelial_dysregulation seen in DIS00meningococcal_sepsis .	None
BAC00Escherichia_coli is a major_cause of DIS00neonatal_bacterial_sepsis and DIS00meningitis .	major_cause
Furthermore , we determined that tissue macrophages and dendritic_cells within the liver and spleen are the major_cellular_targets of BAC00E0_coli_K1 and that TraJ significantly contributes to the predominantly intracellular_nature of BAC00E0_coli_K1 within these professional_phagocytes exclusively during the early_stages of DIS00systemic_disease .	None
These data indicate that , contrary to earlier indications , BAC00E0_coli_K1 resides within professional_phagocytes , and this is essential for the efficient_progression of DIS00systemic_disease .	None
DIS00Zwitterionic_polysaccharides ( Zps ) from pathogenic_bacteria , such as BAC00Bacteroides_fragilis , are virulence factors responsible for DIS00abscess formation associated with DIS00intra0abdominal_sepsis .	pathogenic_bacteria
By contrast , prior_experience with BAC00E0_coli abscess production resulted in 25 % failure rate of abscess production or DIS00death from DIS00sepsis .	result
Two putative_types of siderophore synthesis operons , named BAC00Bacillus_anthracis catechol , bac ( anthrabactin ) , and DIS00anthrax siderophore biosynthesis , asb ( anthrachelin ) , were identified .	None
Successful_establishment of DIS00sepsis by entrapping a dose of 150 colony forming units of BAC00Klebsiella_pneumoniae in a fibrin_clot following implantation into the peritoneal_cavity of mice is reported .	Successful_establishment
Gram-negative_bacteria were most commonly found as a cause of early_onset DIS00sepsis , with BAC00Enterobacter_aerogenes as the most common_agent .	common_agent
BAC00Enterobacter_aerogenes is an important_pathogen in the etiology of early_onset DIS00sepsis in the newborn at the State University Hospital of Haiti , while Group B BAC00Streptococcus is the leading cause of DIS00meningitis in that age group .	important_pathogen
BACKGROUND : The relative_contributions of the cytotoxic_phenotype of BAC00P0_aeruginosa expressing DIS00type_III_secretory_toxins and an immunocompromised_condition lacking normal_Toll-like_receptor 4 ( TLR4 ) signaling in the pathogenesis of DIS00acute_lung_injury and DIS00sepsis were evaluated in a mouse model for DIS00Pseudomonas_aeruginosa_pneumonia .	express
By using lipopolysaccharide-resistant_C3H/HeJ mice missing normal_TLR4 signaling due to a mutation on the tlr4 gene , we evaluated how TLR4 signaling modulates the DIS00pneumonia caused by BAC00cytotoxic_P0_aeruginosa expressing type III secretory_toxins .	cause
RESULTS : Development of DIS00acute_lung_injury and DIS00sepsis was observed in all mouse strains when the BAC00cytotoxic_P0_aeruginosa strain but not the non-cytotoxic_strain was instilled in the airspaces of the mice .	observe
CONCLUSION : The cytotoxic_phenotype of BAC00P0_aeruginosa is the critical_factor causing DIS00acute_lung_injury and DIS00sepsis in infected_hosts .	cause
Our group found that a whole_bacterial_vaccine made from the BAC00Escherichia_coli O111 : B4 , J5 ( Rc chemotype ) mutant induced protective_antibodies when given passively as treatment for DIS00sepsis in a neutropenic_rat model .	induce, protective_antibodies
BAC00Streptococcus_pneumoniae , BAC00Streptococcus_pyogenes , and staphylococci , organisms that cause respiratory and DIS00cutaneous_infections , and members of the BAC00Enterobacteriaceae and BAC00Pseudomonas families , organisms that cause DIS00diarrhea , DIS00urinary_infection , and DIS00sepsis , are now resistant to virtually all of the older antibiotics .	cause
A unique_case of community acquired methicillin BAC00resistant_Staphylococcus_aureus ( MRSA ) DIS00sepsis , with endocardial and cerebral_metastatic_seeding , caused by a strain representative of the Italian_clone , is described .	None
Whole_blood anticoagulated with lepirudin was stimulated with BAC00wild-type_Neisseria_meningitidis_H44076 ( BAC00LPS + ) , DIS00LPS - BAC00deficient_N0_meningitidis H44/76lpxA ( DIS00LPS - ) , or purified DIS00meningococcal_LPS ( NmLPS ) at concentrations that were relevant to DIS00meningococcal_sepsis .	None
BAC00Streptococcus_agalactiae is a major_cause of DIS00bacterial_sepsis and DIS00meningitis in human_newborns .	major_cause
MICs of MEPM against 6 clinically isolated bacteria ( B. catarrhalis 2 , BAC00S0_pneumoniae 3 and BAC00S0_aureus 1 ) from children with DIS00bacterial_infections were examined .	isolate
We describe such a patient who contracted DIS00sepsis from BAC00Pseudomonas_aeruginosa .	from
Burn DIS00sepsis during shock stage occurred in 4 cases ( 9.09 % ) , in which one was caused by BAC00Pseudomonas_aeruginosa and other three possibly by BAC00Escherichia_coli , BAC00Streptococcus faecalis and BAC00Bacillus gasoformans .	cause 
BAC00Streptococcus_agalactiae ( Group B BAC00Streptococcus : DIS00GBS ) is the major_causative_agent of DIS00neonatal_sepsis .	major_causative_agent
Log reduction of Gram-positive_bacteria for BAC00Staphylococcus_epidermidis was > 6.6 ; for BAC00Staphylococcus_aureus , 6.6 ; for BAC00Streptococcus_pyogenes , > 6.8 ; for BAC00Listeria_monocytogenes , > 6.3 ; for BAC00Corynebacterium_minutissimum , > 6.3 ; for BAC00Bacillus_cereus ( vegetative ) , > 5.5 ; for BAC00Lactobacillus sp. , > 6.4 ; for BAC00Bifidobacterium_adolescentis , > 6.0 ; for BAC00Propionibacterium_acnes , > 6.2 ; and for BAC00Clostridium_perfringens , > 6.5 . Log reduction of Gram-negative_bacteria for BAC00Escherichia_coli was > 6.4 ; for BAC00Serratia_marcescens , > 6.7 ; for BAC00Klebsiella_pneumoniae , > 5.6 ; for BAC00Pseudomonas_aeruginosa , 4.5 ; for DIS00Salmonella_choleraesuis , > 6.2 ; for BAC00Yersinia_enterocolitica , > 5.9 ; and for BAC00Enterobacter_cloacae , 5.9 .	None
CONCLUSION : In contrast to DIS00extravascular_infection , DIS00sepsis with BAC00intravascular_E0_coli in canines and BAC00S0_aureus in rats may not provide a compartmentalized_nidus of bacteria on which G-CSF-stimulated_neutrophils can exert a beneficial_antimicrobial_effect .	with
Moreover , review of photographs on file at the Centers for DIS00Disease Control revealed this dramatic_color change in 2 units of blood that caused DIS00transfusion-transmitted_sepsis ( BAC00Enterobacter agglomerans and an BAC00unidentified_gram-negative_bacillus , not BAC00Yersinia sp . ) , which demonstrated that the color change was not limited to BAC00Y0_enterocolitica .	None
BAC00Vibrio_vulnificus causes DIS00severe_sepsis in humans .	cause
To determine the role of IL-12 in DIS00abdominal_sepsis , p35 gene-deficient ( IL-12 knockout , KO ) mice and DIS00normal_wild0type ( WT ) mice were injected intraperitoneally with BAC00Escherichia_coli .	None
Gram-negative_bacteria were the cause of DIS00sepsis in 57 % of patients ( Pseudomonas -- 20 % , Klebsiella -- 20 % , E. coli -- 8.5 % , Acinetobacter -- 8.5 % ) , gram-positive in 43 % ( coagulase-negative_Staphylococci -- 14 % , BAC00Staphylococcus epidermidis -- 14 % , BAC00Staphylococcus aureus -- 9 % , BAC00Streptococcus group B -- 3 % , BAC00Listeria monocytogenes -- 3 % ) .	cause
BAC00Stenotrophomonas_maltophilia is an emerging pathogen implicated in an increasing number of DIS00severe_pulmonary_infections and DIS00nosocomial_sepsis .	pathogen
We also investigated the influence of the above mentioned antibiotics on the ability of BAC00S0_maltophilia culture filtrates and DIS00S0_maltophilia_LPS , extracted in our laboratory , to stimulate DIS00sepsis mediators such as DIS00tumor_necrosis factor a ( TNF-a ) , interleukin 8 ( IL-8 ) , interleukin 10 ( IL-10 ) , Nitric_Oxide ( NO ) and as bactericidal / permeability-increasing_protein ( BPI ) in human_whole_blood .	None
We describe the first reported case of DIS00infection due to BAC00O0_anthropi in a child , that of DIS00bacteremia in a 3-year-old_girl undergoing chemotherapy for DIS00retinoblastoma .	due
BAC00Vibrio_vulnificus is an opportunistic_pathogen of humans that has the capability of causing rare , yet devastating DIS00disease .	opportunistic_pathogen
Additionally , in otherwise healthy_people , BAC00V0_vulnificus causes wound DIS00infection that can require amputation or lead to DIS00sepsis .	cause
Despite the analysis of virulence for over 20 years using a combination of animal and cell culture models , surprisingly little is known about the mechanisms by which BAC00V0_vulnificus causes DIS00disease .	cause
BAC00Salmonella_enterica serovar Choleraesuis ( S. Choleraesuis ) , a highly invasive_serovar among BAC00non-typhoidal_Salmonella , usually causes DIS00sepsis or extra - DIS00intestinal_focal_infections in humans .	cause
In this study , we have determined the role of mast cells in the inflammatory_response and DIS00disease induced by BAC00C0_rodentium .	induce
BACKGROUND : Despite routine_bacterial_screening with a bacterial_culturing system ( BacT/ALERT , bioMerieux ) of platelet ( PLT ) concentrates , two cases of DIS00life-threatening_sepsis attributed to transfused PLT products contaminated with BAC00Bacillus_cereus were reported to the regional_hemovigilance office in the southwest region of the Netherlands .	contaminate
The importance of bacteria in DIS00sepsis0related_lung_injury was studied in rats given an intraperitoneal_injection of BAC00E0_coli or in rats given the adjuvant_substance alone in capsules intraperitoneally .	intraperitoneal_injection
INTERVENTIONS : DIS00Abdominal_sepsis was induced by the intraperitoneal_injection of BAC00Escherichia_coli . DIS00Pancreatitis was induced by 12 hourly_intraperitoneal_injections of cerulein .	induce
In this study , BAC00Escherichia_coli 25922 ( BAC00E0_coli 25922 ) and DIS00LPS were used to induce DIS00sepsis in an animal model .	induce
BAC00Neisseria_meningitidis is a major_cause of DIS00sepsis and/or DIS00meningitis .	major_cause
Especially in ICU patients with DIS00severe_pneumonia ( NP or CAP ) or DIS00septicemia and risk factors like underlying DIS00diseases , antibiotic_pretreatment or mechanical_ventilation , agents with an appropriate_spectrum encompassing BAC00Pseudomonas_aeruginosa as well as other_Gram-negative_bacteria like BAC00Escherichia_coli , BAC00Klebsiella spp. , BAC00Enterobacter spp . and Gram-positive_bacteria ( e.g. BAC00Staphylococcus_aureus , pneumococci and streptococci ) are recommended as treatment of choice .	agent
Unlike most other_pathogens in CF , which typically remain confined to the endobronchial_spaces , BAC00B0_cenocepacia can traverse airway epithelium to cause DIS00bacteremia and DIS00sepsis .	cause
Although 3OC12-HSL production by BAC00P0_aeruginosa was important for virulence in a mouse DIS00sepsis model , Pon1-knock-out_mice were paradoxically protected .	important
BACKGROUND : An experimental_vaccine for DIS00sepsis , composed of detoxified BAC00Escherichia_coli J5 lipopolysaccharide ( LPS ) complexed with the outer_membrane protein ( OMP ) of BAC00Neisseria_meningitidis group B , induces anti-core_glycolipid antibody and has been tested in pilot studies in human_volunteers .	experimental_vaccine
Here we show the existence in BAC00septicemic_E0_coli strains of an ETT2 gene cluster , ETT2 ( DIS00sepsis ) , which , although degenerate , contributes to pathogenesis .	None
ETT2 ( DIS00sepsis ) has several_premature_stop codons and a large ( 5 kb ) deletion , which is conserved in 11 BAC00E0_coli strains from cases of DIS00septicemia and DIS00newborn_meningitis .	from
The single_episode of DIS00early-onset_sepsis was caused by BAC00Listeria_monocytogenes , while all remaining episodes were late-onset with the following organisms : BAC00Staphylococcus_epidermidis ( 7 ) , BAC00methicillin-resistant_Staphylococcus_aureus ( MRSA ) ( 3 ) , combined MRSA and Candida albicans ( 2 ) , Candida albicans alone ( 2 ) , late-onset_Group B BAC00beta-hemolytic_Streptococcus ( GBS ) ( 2 ) , BAC00Klebsiella_pneumoniae ( 2 ) , BAC00Enterococcus fecalis ( 1 ) , BAC00Escherichia_coli ( 1 ) , and BAC00Serratia_marcescens ( 1 ) .	cause
In contrast to TLR4-deficient_mice , SPRET/Ei mice resist both DIS00LPS and DIS00sepsis induced with BAC00Klebsiella_pneumoniae .	induce
METHODS : BAC00E0_coli was injected intraperitoneally to produce rats DIS00sepsis models .	inject
When mice were treated with ginsan before the bacterial_challenge with BAC00S0_aureus , they were highly protected from DIS00sepsis0induced_death .	None
DIS00Sepsis due to BAC00Staphylococcus_aureus was associated with vascular and joint_devices whereas BAC00Pseudomonas_aeruginosa and Gram-negative_rods were more common with genitourinary_devices and DIS00lymphoproliferative_disease .	due
INTRODUCTION : BAC00Streptococcus_suis is a BAC00bacterium causing a DIS00disease in pigs and rarely in humans .	cause
Finally , the protective_effect of chronic_acid water feeding on DIS00gut-derived_sepsis due to BAC00P0_aeruginosa was tested in mice .	due
Chronic_acid water feeding protected_mice from the lethal_gut derived DIS00sepsis due to BAC00P0_aeruginosa .	due
DIS00Adult_male_Wistar_rats ( i ) were given an intraperitoneal_injection of 1 mg BAC00Escherichia_coli 0111 : B4 DIS00LPS , ( ii ) were given 2 x 10 ( 10 ) CFU of BAC00Escherichia_coli_ATCC_25922 , or ( iii ) had DIS00intra0abdominal_sepsis induced via cecal_ligation and puncture .	None
OBJECTIVE : To evaluate the utility of PCT in distinguishing DIS00community0acquired_pneumonia ( CAP ) due to common_bacteria , BAC00Mycobacterium_tuberculosis and DIS00Pneumocystis_jirovecii in a high_human_immunodeficiency virus ( DIS00HIV ) prevalence setting .	due, common_bacteria
Pharmacological_inhibition of apoptosis in wild-type_mice by intravenous_injection of the broad-spectrum_caspase inhibitor zVAD-cmk mimicked the phenotype of Gfi1-deficient_mice and resulted in a profound_sensitization of mice to BAC00P0_aeruginosa , an increased release of cytokines , DIS00sepsis and death of the animals .	None
Continuous_infusion of Intralipid ( 0.9 g/100 g bw/d ) or saline ( controls ) was started immediately after induction of DIS00hyperdynamic_intra0abdominal_sepsis ( bacterial_agents : BAC00E0_coli , B. thetaiotamicron ) .	bacterial_agents
The purpose of this study was to evaluate the direct_effect of genistein on the survival and growth of the BAC00probiotic_Lactobacillus_reuteri and selected opportunistic_bacteria in vitro as a prelude to in vivo use for managing postirradiation DIS00sepsis	None
BAC00Vibrio_vulnificus is BAC00Gram-negative_bacterium that contaminates oysters , causing highly DIS00lethal_sepsis after consumption of raw_oysters and wound DIS00infection .	cause
BAC00Yersinia_pestis causes DIS00bubonic_plague , characterized by an enlarged , DIS00painful_lymph_node , termed a bubo , that develops after bacterial_dissemination from a fleabite site .	cause
The fulminant_progression of DIS00disease has been largely ascribed to the ability of BAC00Y0_pestis to avoid phagocytosis and exposure to antimicrobial_effectors of innate_immunity .	ascribe
tudies that define natural_responses to DIS00bacterial_sepsis assumed new_relevance after the lethal_bioterrorist attacks with BAC00Bacillus_anthracis ( BAC00anthrax ) , a spore-forming , BAC00toxigenic_gram-positive_bacillus .	None
In the present_study , the effect of morphine withdrawal on DIS00spontaneous_sepsis and on DIS00oral_infection with BAC00Salmonella_enterica serovar Typhimurium was examined .	with
Oleuropein , a novel_immunomodulator derived from olive_tree , was assessed in vitro and in DIS00experimental_sepsis by BAC00Pseudomonas_aeruginosa .	by
In DIS00cystic_fibrosis ( DIS00CF ) , bacteria of the BAC00Burkholderia_cepacia complex ( Bcc ) can induce a DIS00fulminant_inflammation with DIS00pneumonitis and DIS00sepsis .	induce
BAC00Streptococcus_pneumoniae and BAC00Streptococcus_agalactiae cause DIS00distinct_infectious_diseases in small_children .	cause
DIS00Primary_infectious_disease issues included DIS00endocarditis , DIS00tracheitis , DIS00pneumonia , or central_line DIS00sepsis resulting from BAC00Staphylococcus_epidermidis , BAC00methicillin-resistant_Staphylococcus_aureus , and BAC00Enterococcus .	result
The 50 % protective_doses were < or = 1 mg/kg of body weight against BAC00S0_aureus in the DIS00sepsis model , while decreases in the numbers of CFU per thigh equal to or greater than those detected in animals treated with a standard_dose of vancomycin were seen in the animals with thigh DIS00infections .	None
BAC00Neisseria_meningitidis is a human_pathogen that causes DIS00septicemia and DIS00meningitis with high_mortality .	human_pathogen, cause
Because the clinical_symptoms and signs of DIS00necrotizing_fasciitis and DIS00sepsis caused by these two bacteria are similar , the purposes of this study were to describe the clinical_characteristics of BAC00Vibrio_vulnificus and DIS00Aeromonas_infections , to analyze the risk factors for DIS00death , and to compare the effects of surgical_treatment on the outcome .	None
METHODS : The cases of thirty-two patients with necrotizing DIS00soft-tissue_infections and DIS00sepsis caused by BAC00Vibrio_vulnificus ( seventeen patients ) and BAC00Aeromonas species ( fifteen patients ) were retrospectively reviewed over a four-year_period .	cause
CONCLUSIONS : The contact history of patients with a rapid_onset of DIS00cellulitis can alert clinicians to a differential_diagnosis of DIS00soft-tissue_infection with BAC00Vibrio_vulnificus ( contact with seawater or raw_seafood ) or BAC00Aeromonas species ( contact with fresh or brackish_water , soil , or wood ) .	with
To investigate the influence of iNOS , we studied models of DIS00acute_bacterial_sepsis using acute_challenges with aerobic ( BAC00Escherichia_coli ) and anaerobic ( BAC00Bacteroides_fragilis ) bacteria in the presence of AG .	None
BAC00Klebsiella_pneumoniae is an important_cause of DIS00nosocomial_Gram-negative_sepsis .	important_cause
Endosialidase ( endo-N-acetylneuraminidase ) is a tailspike_enzyme of bacteriophages specific for BAC00human_pathogenic_Escherichia_coli_K1 , which specifically recognizes and degrades polySia ( polysialic_acid ) . polySia is also a polysaccharide of the capsules of DIS00other_meningitis - and DIS00sepsis - causing bacteria , and a post-translational_modification of the NCAM ( neural_cell-adhesion molecule ) .	None
METHODS : Neutropenic_mice with BAC00Escherichia_coli or DIS00Pseudomonas_aeruginosa_sepsis were treated with ceftazidime or meropenem 10-320 mg/kg as an intravenous_bolus or as continuous_tail vein infusions of 0.1 mL/h .	with
METHODS : Circulating concentrations of MIF were measured in 2 clinical_trial cohorts of 145 pediatric and adult_patients who had DIS00severe_sepsis or DIS00septic_shock caused predominantly by DIS00infection with BAC00Neisseria_meningitidis or other_gram-negative_bacteria , to study the kinetics of MIF during DIS00sepsis , to analyze the interplay between MIF and other_mediators of DIS00sepsis or stress hormones ( adrenocorticotropic_hormone and cortisol ) , and to determine whether MIF is associated with patient outcome .	with
Presented herein is the case of a 29 year old_woman with CGD who suffered from DIS00bacteria0associated_haemophagocytic_syndrome and a DIS00septic_pulmonary_embolism following a DIS00uterine_infection and DIS00sepsis , caused by BAC00Burkholderia_cepacia complex .	cause
Gram-negative_organisms were isolated in 66 cases ( 31.43 % ) , and the most common_Gram-negative_organism causing DIS00neonatal_sepsis was BAC00Klebsiella_pneumoniae .	cause
The distribution of the main_pathogens is different in the Azerbaijan state , northwest of Iran , and BAC00K0_pneumoniae is predominant , but BAC00Streptococcus_agalactiae plays a relatively minor_role in the etiology of DIS00sepsis during the first_month of life .	etiology
METHODS : DIS00Peritoneal_sepsis was induced in mice expressing either functional_TLR4 ( TLR4-wild-type -LSB- WT -RSB- ) or mutant_TLR4 by intraperitoneal_injection of either live BAC00Escherichia_coli or DIS00LPS .	None
CONCLUSIONS : We conclude that TLR4 plays a critical_role in the response to BAC00intraperitoneal_E0_coli through effects on phagocytosis by macrophages , suggesting the possibility of using TLR4 as a therapeutic_target in DIS00diseases of DIS00peritoneal_sepsis .	None
BAC00S0_epidermidis is a leading cause of DIS00nosocomial_sepsis , with virulence residing in its ability to establish DIS00chronic_infections through production of slime layers , or biofilms , on biomedical_devices .	cause
RESULTS : We report data on DIS00spontaneous_meningitis and DIS00brain_infection following DIS00oral_infection of mice with BAC00Salmonella_enterica serovar Typhimurium .	with
CGD mice , challenged intratracheally with 10 ( 3 ) cells of the BAC00epidemic_Burkholderia_cenocepacia strain J2315 , died within 3 days from DIS00sepsis after bacteria had multiplied to 3.3 x 10 ( 8 ) cells .	None
BAC00Streptococcus_suis , an important_swine and human_pathogen , causes DIS00septic_shock and DIS00meningitis .	cause
METHODS : An experimental_model of DIS00gram-positive_sepsis was used in which liver-specific_gp130-deficient_mice ( FVB/n alfpCre + gp130 ( LoxP/LoxP ) ) and wild-type_mice ( FVB/n gp130 ( LoxP/LoxP ) ) were intravenously infected with BAC00Streptococcus_pyogenes .	None
To determine the role of the CD14 DIS00LPS receptor in the pathogenic_effects of naturally occurring BAC00E0_coli , the responses of CD14 - / - and CD14 + / + mice to three different_isolates of BAC00E0_coli obtained from DIS00sepsis patients were compared ; two isolates express both smooth DIS00LPS and the K1 antigen , while the third_isolate expresses only DIS00LPS and is negative for K1 .	from
Immunological_reactivity of the antigens mixture with two human_sera : highly positive ( with three BAC00S0_aureus antigens in ELISA ) from patient with DIS00staphylococcal_sepsis and negative ( from blood donor ) were analysed .	from
Mortality was associated with age ( P = 0.005 ) , a previous_history of DIS00coronary_heart_disease ( P = 0.016 ) , DIS00absence_of_fever ( P = 0.001 ) , development of DIS00sepsis and/or DIS00septic_shock ( P < 0.001 ) , raise of bilirubin levels ( P = 0.004 ) , a biliary ( P = 0.035 ) , or cryptogenetic_origin ( P = 0.039 ) , DIS00infection owing to BAC00E0_coli ( P = 0.01 ) or to Candida ( P = 0.009 ) and development of DIS00pneumonia ( P < 0.001 ) .	None
The authors report the first_case of BAC00methicillin-resistant_Staphylococcus_aureus ( MRSA ) DIS00meningitis in a patient with such a pump successfully treated with linezolid without the need for removal of the intrathecal_pump .	None
The BAC00Staphylococcus_aureus cell surface protein clumping factor A ( ClfA ) and the enzyme sortase A ( SrtA ) , which attach surface proteins to the cell wall , have both been shown to be virulence factors in models of DIS00septic_arthritis and DIS00sepsis .	virulence, factor
The mRNA levels of clfA , srtA and the putative_housekeeping gene gyrase B ( gyrB ) in BAC00S0_aureus were determined using real-time_PCR during the course of DIS00sepsis0septic_arthritis .	None
We used ciprofloxacin to induce a predominantly BAC00gram-positive_Enterococcus_faecalis DIS00polymicrobial_sepsis in rats .	None
AIMS : The aim of the study was to evaluate the efficacy of probiotics on DIS00gut-derived_sepsis caused by BAC00Pseudomonas_aeruginosa in immunocompromised_mice .	cause
METHODS AND RESULTS : After oral_inoculation of BAC00P0_aeruginosa , mice were treated with cyclophosphamide to induce DIS00leucopenia and translocation of the BAC00intestinal_P0_aeruginosa into blood , thereby producing DIS00gut-derived_sepsis .	produce
CONCLUSION : Oral_administration of BAC00B0_longum protects mice against DIS00gut-derived_sepsis caused by BAC00P0_aeruginosa , and the effect may be due to interference of BAC00P0_aeruginosa adherence to intestinal_epithelial_cells .	cause
The FcRgamma-associated_receptor that inhibits BAC00E0_coli phagocytosis is FcgammaRIII ( also called CD16 ) , and its absence protects mice from DIS00sepsis .	None
Cephtriaxon is the drug of choice for BAC00E0_coli and DIS00Hemophilus_influence_meningitis .	None
In DIS00acute_meningitis of prematures already colonized with BAC00U0_urealyticum , ureaplasmal_cultures and susceptibility test are warranted in Korea .	colonize
In this Commentary , we consider these findings and propose possible_mechanisms by which RAGE exacts a heavy_toll on the host in response to DIS00polymicrobial_sepsis and BAC00L0_monocytogenes .	None
BAC00Methicillin-resistant_Staphylococcus_aureus ( MRSA ) , BAC00Pseudomonas_aeruginosa and BAC00Acinetobacter_baumannii were predominant_causative_agents in both type of DIS00sepsis .	predominant_causative_agents
BAC00E0_coli hemolysin and , possibly , other_related_cytolysins may thus contribute directly to the pathogenesis of DIS00acute_respiratory_failure under conditions of DIS00sepsis or DIS00pneumonia .	contribute
BAC00Staphylococcus_aureus is a known_cause of a variety of illnesses that present to the emergency department , including DIS00skin_and_soft_tissue_infections , DIS00pneumonia , and DIS00sepsis .	contribute
DIS00Lemierre0s_syndrome is characterized by DIS00severe_infection , with DIS00pharyngitis , DIS00sepsis and DIS00thrombosis of the internal_jugular_vein , and is most frequently associated with DIS00upper_airway_infection with BAC00Fusobacterium_necrophorum , often preceded by DIS00infection with Epstein-Barr_virus which enables bacteria growing in the oral_cavity to invade .	with
We developed a BAC00live_Escherichia_coli model of DIS00acute_sepsis in pigs with emphasize on biomarkers reflecting the early_inflammatory_response of DIS00sepsis .	None
The aim of this study was to analyze if these two amino acids which are vital for the fibrinogen binding of ClfA are of importance for the ability of BAC00S0_aureus to generate DIS00disease .	generate
Our data strongly suggest that the fibrinogen binding activity of ClfA is crucial for the ability of BAC00S0_aureus to provoke DIS00disease manifestations , and that the vaccine potential of recombinant_ClfA is improved by removing its ability to bind fibrinogen .	provoke
CONCLUSIONS : BAC00B0_cepacia may be an etiologic_agent of severe_hospital acquired DIS00pneumonia and DIS00sepsis among immunocompromised_patients . DIS00Clinically_infection develops picture of superinfection and usually is life-threatening_condition .	etiologic_agent
BAC00Streptococcus_suis is a major_cause of DIS00meningitis , DIS00sepsis and DIS00arthritis in piglets and a zoonotic_agent .	major_cause
Based on favorable_sensitivity data , penetration into neutrophils and the CNS , and DIS00favorable_toxicity profiles , ciprofloxacin and meropenem would appear to be the most appropriate_antibiotic_treatment options for DIS00systemic_infection_or_meningitis caused by BAC00C0_koseri .	cause
CONCLUSIONS : Ciprofloxacin and meropenem should be considered antibiotic_treatment options for DIS00systemic_infection_or_meningitis caused by BAC00C0_koseri .	cause
In this model mimicking DIS00human_disease , the inflammatory_response to BAC00N0_meningitidis was closely associated with the bacterial_concentration .	None
BAC00Staphylococcus_aureus is a common_etiologic_agent for DIS00Gram-positive_sepsis , and its lipoteichoic_acid ( LTA ) may be important in causing DIS00Gram-positive_bacterial_septic_shock .	common_etiologic_agent
It is frequently caused by BAC00S0_aureus and , in endemic_areas , by BAC00Mycobacterium_tuberculosis and BAC00Brucella spp . We describe 9 cases , from October 2004 to August 2005 , all DIS00spontaneous_diseases occurring in adults ( mean age 64 years ) .	None
Upon BAC00E0_coli inoculation , Cyld ( - / - ) mice were hypersusceptible to DIS00E0_coli_pneumonia with higher mortality .	hypersusceptible
We presently have demonstrated that recombinant_N-terminal_lectinlike_domain of TM ( rTMD1 ) functions as a protective_agent against DIS00sepsis caused by DIS00Gram-negative_bacterial_infections . rTMD1 caused agglutination of BAC00Escherichia_coli and BAC00Klebsiella_pneumoniae and enhanced the macrophage phagocytosis of these Gram-negative_bacteria .	cause 
BAC00Neisseria_meningitidis is a leading cause of DIS00meningitis and DIS00septicemia worldwide , with a rapid_onset of DIS00disease and a high_morbidity and mortality .	cause
Swine influenza virus ( SIV ) and BAC00Streptococcus_suis are common_pathogens of the respiratory_tract in pigs , with both being associated with DIS00pneumonia .	associate
BAC00Ehrlichia_chaffeensis , a tick-borne_rickettsial_organism , causes the DIS00disease DIS00human_monocytic_ehrlichiosis .	cause
DIS00Tuberculosis is primarily a DIS00respiratory_disease that is caused by BAC00Mycobacterium_tuberculosis .	cause
The emergence of BAC00new_antibiotic-resistant_Escherichia_coli pathotypes associated with DIS00human_disease has led to an investigation in terms of the origins of these pathogens .	associate
It is hypothesized that BAC00environmental_E0_coli not typically associated with the ability to cause DIS00disease in humans could potentially be responsible for some of these cases	cause
Under field conditions , DIS00co0infection of AvRVs occurs with other_infectious_agents such as astroviruses , enteroviruses , reoviruses , paramyxovirus , adenovirus , BAC00Salmonella , BAC00Escherichia_coli , cryptosporidium and Eimeria species prospering severity of DIS00disease outcome .	other_infectious_agents
Birds surviving to DIS00RV_disease predominantly succumb to DIS00secondary_bacterial_infections , mostly BAC00E0_coli and BAC00Salmonella spp .	None
UNASSIGNED : BAC00Non-typeable_Haemophilus_influenzae ( NTHi ) live exclusively in the pharynges of humans and are increasingly recognized as pathogens that cause both DIS00localized_infections of the respiratory_tract ( middle_ear spaces , sinuses , and bronchi ) and DIS00systemic_infections such as DIS00bacteraemia and DIS00pneumonia .	cause
Clarifying the mechanism that underlies the QS system between BAC00S0_gordonii and BAC00V0_tobetsuensis may lead to the development of novel_methods for the prevention of DIS00oral_infectious_diseases caused by oral_biofilms .	None
BAC00Pasteurella_multocida is a Gram-negative_bacterial_pathogen causing economically DIS00important_diseases in distinct_animal species .	cause
BACKGROUND : The epidemiology of DIS00salmonellosis is complex because of the diversity and different_serotypes of BAC00Salmonella_enterica ( BAC00S0_enterica ) that occur in different_reservoirs and geographic_incidences .	None
Pneumococcal_conjugate vaccines target the limited_subset of the more than 90 known_serotypes of BAC00Streptococcus_pneumoniae responsible for the greatest burden of DIS00pneumococcal_disease and antibiotic_resistance .	responsible
This study suggests that these compounds represent potential_natural_molecules for the prevention and treatment of BAC00H0_pylori associated DIS00diseases .	associate
Individual_Arabidopsis GAPDH knockouts ( KO lines ) exhibited enhanced DIS00disease resistance phenotypes upon inoculation with the bacterial_plant pathogen BAC00Pseudomonas_syringae_pv0_tomato .	pathogen
ge , betel chewing , and a microbiological_cluster including at least one of BAC00Prevotella_tannerae , BAC00Filifactor_alocis and BAC00Porphyromonas_endodontalis significantly correlated with the severity of DIS00periodontal_disease .	correlate
UNASSIGNED : Recently it has been estimated that the annual_cost of DIS00diseases caused by the waterborne_pathogens DIS00Legionella_pneumonia , BAC00Mycobacterium_avium , and BAC00Pseudomonas_aeruginosa is 500 million .	cause
For the period 2001-2012 , the estimated cost of hospital admissions for DIS00nontuberculous_mycobacterial_pulmonary_disease , the majority caused by BAC00M0_avium , was almost 1 billion .	cause 
BAC00Aerococcus_viridans is a wide_spread BAC00bacterium in the environment and clinically this organism is associated with DIS00different_diseases in animals and humans .	associate
The aim of this study was to test the antitumor_potential of a combination of melatonin and BAC00P0_acnes against DIS00breast_cancer implanted in mice .	against
The combination of melatonin and BAC00P0_acnes has high_efficiency in targeting DIS00breast_cancer in mice .	high_efficiency
The combination of melatonin and BAC00P0_acnes represents a promising_option to treat DIS00breast_cancer .	treat
Antibacterial_activity of the prepared_formulations was evaluated against clinical_strains of BAC00Helicobacter_pylori , isolated from gastric_biopsies of patients with DIS00gastritis , DIS00duodenal_ulcer , DIS00peptic_ulcer , and DIS00gastroesophageal_reflux_disease undergoing endoscopy , by using agar dilution method .	isolate
For the first_time in decades , most ( 60 % ) infants with DIS00early-onset_sepsis were very low_birth weight and BAC00Escherichia_coli ( 45 % ) replaced group B BAC00streptococcus ( 36 % ) as the most common_organism associated with DIS00early-onset_sepsis .	None
DIS00Yersiniosis caused by BAC00Yersinia_enterocolitica has been reported from all continents .	cause
The occurrence of BAC00pathogenic_Escherichia_coli in environmental_waters increases the risk of DIS00waterborne_disease .	increase, risk
OBJECTIVE : To evaluate the efficacy ofprobiotics , BAC00Lactobacillus_casei ( Shirvta strain ) , in reducing the incidence ofventilator - associated DIS00pneumonia ( VAP ) in medical_patients who received mechanical_ventilation at Siriraj Hospital .	None
Although metronidazole resulted in transient_loss of colonization resistance , oral_vancomycin markedly disrupted the microbiota , leading to prolonged_loss of colonization resistance to DIS00C0_difficile_infection and dense_colonization by BAC00vancomycin-resistant_Enterococcus , BAC00K0_pneumoniae , and BAC00E0_coli .	None
Free-range_pigs can be infected by BAC00Mycobacterium_tuberculosis complex ( MTC ) and may contribute to the spread of DIS00bovine_tuberculosis ( bTB ) .	contribute
RESULTS : BAC00M0_genitalium serum IgG was more common among women of infertile couples ( 5.4 % ) than among fertile_controls ( 1.6 % ) ( OR ( 95 % CI ) 3.45 ( 1.10 to 10.75 ) ) , adjusting for DIS00C0_trachomatis_IgG ( adjusted OR = 3.00 ( 0.95 to 9.47 ) ) .	common
CONCLUSIONS : BAC00M0_genitalium serum IgG was associated with DIS00infertility in women , however insignificant after adjustment for DIS00C0_trachomatis_IgG , but not with DIS00infertility subtypes within this study .	associate
The effect of the glucans on DIS00disease resistance was then evaluated by experimentally infecting the fish with BAC00Edwardsiella_ictaluri by immersion and mortalities monitored for 14 days .	infect
However , production of this prawn is facing a serious_threat from DIS00Vibriosis_disease caused by BAC00Vibrio species such as BAC00Vibrio_parahaemolyticus .	cause
BAC00T0_denticola ( P = 0.001 ) , BAC00T0_forsythia ( P < 0.001 ) , and P. micros ( P = 0.003 ) are significantly associated with DIS00periodontal_disease in CKD subjects but in a multivariate_model only age and BAC00T0_forsythia remain independent_risk factors for DIS00periodontal_disease in patients with CKD .	associate
The next_aim was to evaluate the incidence of BAC00S0_agalactiae early_onset DIS00sepsis in newborns from PPROM pregnancies , with respect to the presence of BAC00S0_agalactiae in the vagina and the amniotic_fluid .	incidence, presence
Early onset DIS00neonatal_sepsis developed in one newborn from pregnancies complicated by the presence of BAC00S0_agalactiae in the amniotic_fluid .	by
Cultivation-negative_findings of BAC00S0_agalactiae in the vagina did not exclude the positivity of the amniotic_fluid for BAC00S0_agalactiae and the development of early_onset DIS00sepsis in newborns .	None
We used novel_real-time_multiplex_PCR assays to detect BAC00S0_aureus , MRSA , BAC00E0_coli , BAC00P0_aeruginosa , BAC00S0_pneumoniae , H. DIS00influenza and BAC00Acinetobacter spp .	None
BAC00Enterotoxin-producing_Escherichia_coli ( ETEC ) are one of the main_causative_agents of DIS00diarrhea in children especially in developing countries and travel DIS00diarrhoea in adults .	main_causative_agents
BAC00Rickettsia_typhi is the causal_agent of DIS00murine_typhus ; a worldwide_zoonotic and DIS00vector-borne_infectious_disease , commonly associated with the presence of domestic and wild_rodents .	causal_agent
BAC00Leptospira_interrogans has been identified to cause DIS00leptospirosis , a DIS00widespread_zoonotic_disease that has been identified in domestic and wild_animals .	cause
BACKGROUND : Globally , over 800 000 children under five die each year from DIS00infectious_diseases caused by BAC00Streptococcus_pneumoniae .	cause
Discussion These results demonstrate that CGK fermented by mixed_culture of BAC00B0_subtilis and BAC00L0_sakei could exert a wide_range of beneficial_activities for DIS00neurodegenerative_diseases , including DIS00Alzheimer , DIS00Parkinson , and DIS00Huntington_disease .	beneficial_activities
The oral_clinical_examination to assess DIS00periodontal_disease ; gingival_fluid sample collection for quantification of the periodontopathogenic_bacteria BAC00Porphyromonas_gingivalis , BAC00Tannerella_forsythia , BAC00Treponema_denticola , and BAC00Prevotella_intermedia using q-PCR ; DIS00body_mass_index ( BMI ) and for collection of the individual 's health-related_data from medical_files .	None
CONCLUSION : The DIS00periodontal_disease increased in severity and BAC00P0_gingivalis increased after GBS .	None
To identify the immune_mechanisms responsible for ineffective_clearance of BAC00Coxiella_burnetii in patients who developed DIS00chronic_Q_fever , we compared serum concentrations of 47 DIS00inflammation - associated markers among patients with DIS00acute_Q_fever , DIS00vascular_chronic_Q_fever , and past resolved DIS00Q_fever .	None
Serum responses for these and other_markers indicate that type I immune_responses to BAC00C0_burnetii are affected in DIS00chronic_Q_fever patients .	affect
UNASSIGNED : BAC00Salmonella_enterica serovar Pullorum ( S. Pullorum ) is a highly adapted pathogen that causes DIS00Pullorum_disease ( PD ) , an DIS00important_systemic_disease of poultry that causes severe_economic_losses in developing countries .	pathogen, cause
This 3-mAb_combination protected animals against mortality and also reduced severity and duration of DIS00diarrhea associated with challenge with highly virulent_strains of BAC00C0_difficile toxinotypes 0 and III .	associate
UNASSIGNED : The well-established_safety profile of the DIS00tuberculosis vaccine strain , BAC00Mycobacterium_bovis bacille Calmette-Gu rin ( BCG ) , makes it an attractive_vehicle for heterologous_expression of antigens from clinically relevant_pathogens .	None
UNASSIGNED : BAC00Burkholderia_gladioli was described as a plant pathogen , and it is a rare_cause of DIS00infection in humans B56hat is primarily associated with DIS00human_pulmonary_infections , such as DIS00chronic_granulomatous_disease and DIS00cystic_fibrosis .	rare_cause
Of the 2,676 participants , 87 ( 3.25 % ) had a BAC00positive_B0_gladioli blood culture that occurred > 72 h after birth , including a premature_group ( 54.0 % , DIS00asphyxia -LSB- vs. 9.20 % -RSB- , DIS00fever -LSB- vs. 13.80 % -RSB- , DIS00pneumonia -LSB- vs. 6.90 % -RSB- and DIS00hyperbilirubinaemia -LSB- vs. 8.05 % -RSB- ) and newborns with DIS00necrotising_enterocolitis ( DIS00NEC ) ( vs. 5.75 % ) .	None
DIS00Invasive_meningococcal_disease ( DIS00IMD ) caused by BAC00Neisseria_meningitidis serogroup Y has increased in Europe , especially in Scandinavia .	cause
UNASSIGNED : BAC00Shigella_sonnei , an emerging global_cause of DIS00shigellosis , consists of four distinct_lineages and the current_pandemic involves several geographically associated , multidrug-resistant_clones that belong to lineage III ( 1-3 ) .	global_cause
UNASSIGNED : BAC00Haemophilus_influenzae type b ( Hib ) is , in contrast to BAC00non-b_H0_influenzae , associated with DIS00severe_invasive_disease such as DIS00meningitis and DIS00epiglottitis in small_children .	associate
Hansen A/S ) ( hereafter , BAC00L0_casei 431 ) on immune_response to DIS00influenza vaccination and respiratory_symptoms in healthy_adults .	None
Subjects were randomly assigned to receive an acidified milk drink containing > = 10 ( 9 ) colony-forming_units of BAC00L0_casei 431 ( n = 553 ) or placebo ( n = 551 ) for 42 d . After 21 d , subjects received the DIS00seasonal_influenza vaccination .	None
RESULTS : There was no effect of BAC00L0_casei 431 on immune_responses to DIS00influenza vaccination .	immune_responses
CONCLUSIONS : Daily consumption of BAC00L0_casei 431 resulted in no observable_effect on the components of the immune_response to DIS00influenza vaccination but reduced the duration of upper_respiratory_symptoms .	no, observable_effect
A BAC00carbapenem-nonsusceptible_Enterobacter_aerogenes strain named 3-SP was isolated from a human_case of DIS00pneumonia in a Chinese_teaching hospital .	isolate
The objectives of this study were to assess the prevalence of DIS00bacterial_vaginosis in women attending Gynaecology Outpatient Department ( O.P.D ) and sexually transmitted DIS00disease ( S.T.D. ) clinic and to assess the role of BAC00Gardnerella_vaginalis as an etiological_agent of DIS00bacterial_vaginosis .	etiological_agent
BAC00Gardnerella_vaginalis was isolated in only 8.7 % cases of DIS00bacterial_vaginosis .	isolate
UNASSIGNED : BAC00Streptococcus_pneumoniae is a rarely cause of DIS00neonatal_sepsis .	cause
Measures to prevent BAC00Streptococcus_agalactiae transmission could help to increase DIS00Invasive_Pneumococcal_Disease ( DIS00IPD ) in newborns .	increase
CONCLUSION : In DIS00neonatal_sepsis , we always think in BAC00Streptococcus_agalactiae .	None
BACKGROUND : DIS00Plague , a DIS00zoonotic_disease caused by BAC00Yersinia_pestis , is characterized by its ability to persist in the DIS00plague natural_foci .	cause
On July 8 , 2014 , the Colorado Department of Public Health and Environment ( CDPHE ) laboratory identified BAC00Yersinia_pestis , the BAC00bacterium that causes DIS00plague , in a blood specimen collected from a man ( patient A ) hospitalized with DIS00pneumonia .	cause
This outbreak highlights 1 ) the need to consider DIS00plague in the differential_diagnosis of ill_domestic_animals , including dogs , in areas where DIS00plague is endemic ; 2 ) the limitations of automated diagnostic_systems for identifying rare_bacteria such as BAC00Y0_pestis ; and 3 ) the potential for DIS00milder_plague illness in patients taking antimicrobial_agents .	None
DIS00Hospital_laboratorians should be aware of the limitations of automated identification systems , and clinicians should suspect DIS00plague in patients with clinically compatible_symptoms from whom BAC00P0_luteola is isolated .	None
BACKGROUND : The bacteria BAC00Orientia_tsutsugamushi is the causative_agent of DIS00scrub_typhus , DIS00mite-borne_disease , which causes an DIS00acute_febrile_illness in patients .	causative_agent
Serogroup A of BAC00Neisseria_meningitidis is the organism responsible for causing DIS00epidemic_diseases in developing countries by a pilus-mediated_adhesion to human_brain endothelial_cells .	cause
Surprisingly , we found extensive_cross-talk among the DIS00M0_tuberculosis_TCSs , significantly more than that in the TCSs in BAC00Escherichia_coli or BAC00Caulobacter crescentus , thereby offering an alternate to specificity paradigm in TCS signalling .	None
The following bacteria were isolated and cultured from both groups with no meaningful_difference in prevalence : BAC00Streptococcus viridans ( p = 0.265 ) , BAC00Staphylococcus_aureus ( p = 0.72 ) , H. DIS00influenza ( p = 0.806 ) , Entrococcus .	None
Fourteen cases were caused by BAC00Fusobacterium_necrophorum , including four cases with CSVT , 7/8 cases of DIS00mastoiditis , four of them with DIS00subperiosteal_abscess formation ; all four cases with DIS00meningitis and two brain abscesses .	cause
UNASSIGNED : Early_signs of DIS00pulmonary_disease with BAC00Mycobacterium_abscessus complex ( MABSC ) can be missed in patients with DIS00cystic_fibrosis ( DIS00CF ) .	miss
BAC00Brucella_abortus is the etiologic_agent of DIS00Brucellosis , a DIS00zoonotic_infection affecting a wide_range of animals .	etiologic_agent
OBJECTIVES : DIS00Yersiniosis , a DIS00foodborne_infection of zoonotic_origin caused by the bacteria BAC00Yersinia_enterocolitica and BAC00Yersinia_pseudotuberculosis , is a DIS00reportable_disease in 38 states .	cause
Although only BAC00B0_pseudomallei is responsible for a significant_number of human_cases , both organisms are classified as Tier 1 Select Agents and their DIS00diseases lack effective_diagnosis and treatment .	responsible
The DIS00AdvanSure_tuberculosis / non - BAC00tuberculous_mycobacterium ( TB/NTM ) PCR ( LG Life Science , Korea ) and COBAS TaqMan BAC00Mycobacterium_tuberculosis ( BAC00MTB ) PCR ( Roche Diagnostics , USA ) are commonly used in clinical_microbiology laboratories .	None
His hospital course is described and reveals an DIS00encephalopathy caused by the BAC00Bartonella_henselae_bacterium also known as cat-scratch DIS00disease .	cause
UNASSIGNED : BAC00Campylobacter_jejuni is one of the most common_bacterial_causes of DIS00human_gastroenterocolitis worldwide , leading to DIS00diarrhea and other_serious_post-infectious_complications .	common_bacterial_causes
This review has collated the studies conducted using probiotics to inhibit BAC00C0_jejuni colonization and growth to date to provide a collective_knowledge about the role of probiotics as an alternative_intervention strategy for DIS00campylobacteriosis .	None
UNASSIGNED : DIS00Contagious_equine_metritis ( CEM ) is a DIS00bacterial_infectious_disease of horses caused by BAC00Taylorella_equigenitalis , a BAC00Gram-negative_eubacterium .	cause
Our study highlights that seabirds from the north-eastern_Atlantic Ocean are carrying DIS00several_chlamydial_organisms , including BAC00C0_psittaci - related_strains .	include
BAC00Xanthomonas_arboricola is divided into pathovars , some of which are classified as quarantine organisms in many_countries and which are responsible for DIS00diseases on nut and stone fruit trees that have emerged worldwide .	responsible
Majority of DIS00brucellosis cases were caused by BAC00B0_melitensis ; only one index case was linked to BAC00B0_abortus .	cause
This case indicates that BAC00C0_difficile may not only be related to DIS00diarrheic_diseases , but also to DIS00infections of non-healing_wounds , especially in situations when BAC00C0_difficile is the only isolated pathogen .	relate
BAC00Trueperella_pyogenes , BAC00Staphylococcus_aureus , BAC00Pseudomonas_aeruginosa , DIS00Klebsiella_pneumonia , BAC00Streptococcus zooepidemicus , and BAC00b-hemolytic_Streptococcus were isolated from females presented for repeat DIS00breeding_syndrome .	isolate
BAC00Streptococcus_pneumoniae is a common_cause of DIS00infectious_diseases in children that may lead to life-threatening_complications .	common_cause
By comparing the whole_genomes of BAC00S0_sonnei isolated from vaccinees and from volunteers in the control group , we show at a very high_sensitivity that a BAC00potent_S0_sonnei glycoconjugate that conferred 74 % protective_efficacy against the DIS00homologous_disease did not induce changes in the genome of BAC00S0_sonnei and in particular on the O-antigen gene cluster .	None
Our results showed that OW-14 adjuvanted inactivated swine DIS00influenza viruses ( SIV ; H3N2 and H1N1 ) and BAC00Mycoplasma_hyopneumoniae ( BAC00M0_hyo ) vaccines could be safely administered to piglets in two doses , three weeks apart .	None
UNASSIGNED : The effect of BAC00Lactobacillus_casei administered along with a DIS00live_attenuated_vaccine_vs0_bovine_babesiosis ( VAC ) on induction of IgG1 and IgG2 antibodies to DIS00Babesia_bovis_and_Babesia_bigemina was assessed by the indirect_fluorescent_antibody test ( IFAT ) in bovines of an endemic_babesiosis area before ( day 0 ) and after vaccination ( days 15 and 30 ) .	along
Most detectable_gram-negative_bacteria were BAC00E0_coli and DIS00Klebsiella_pneumonia .	None
DIS00Bacteremia and DIS00infective_endocarditis caused by BAC00Staphylococcus_aureus are common and DIS00severe_diseases .	cause
Both DIS00bacteremia and DIS00infective_endocarditis caused by BAC00Staphylococcus_aureus are common and DIS00severe_diseases .	cause
UNASSIGNED : DIS00Invasive_Salmonellosis caused by DIS00Salmonella_enterica_serotype_Typhi or Paratyphi A , B , C , or BAC00invasive_non-typhoidal_Salmonella serotypes , is an immensely DIS00important_disease cluster for which reliable , rapid_diagnostic_tests are not available .	cause
At species level , potential_pathogens BAC00Arcobacter_butzleri , BAC00Aeromonas_hydrophila and DIS00Klebsiella_pneumonia dominated in raw_sewage , which was also confirmed by quantitative_real_time PCR .	None
Because the DIS00human_periodontal_disease pathogen , BAC00Porphyromonas_gingivalis ( Pg ) , interacts with innate_immune_receptors Toll-like_Receptor ( TLR ) 2 and CD36/scavenger receptor-B2 ( SR-B2 ) , we studied how CD36/SR-B 2 and TLR pathways promote DIS00Pg0mediated_atherosclerosis .	pathogen
CONCLUSIONS : The isolation of the highly infectious_pathogen BAC00B0_melitensis from seropositive_workers is consistent with the notion that the pathogen may persist in the blood without causing DIS00overt_disease .	None
While vaccination with strain S19 is essential for the control of DIS00bovine_brucellosis the vaccine strain may be transmitted to the human_population and protective_measures remain important to prevent exposure also in view of the presence of BAC00B0_melitensis .	None
After establishing that mouse neutrophil elastase cleaves mouse DIS00HGF in vitro , we tested our predictions in vivo by examining lung pathology and DIS00HGF in mice infected with BAC00Mycoplasma_pulmonis , which causes DIS00neutrophilic_tracheobronchitis and DIS00pneumonia .	cause
The aquatic_pathogen , BAC00Streptococcus_iniae , is responsible for over 100 million dollars in annual_losses for the aquaculture industry and is capable of causing DIS00systemic_disease in both fish and humans .	cause
UNASSIGNED : BAC00Acinetobacter_baumannii is a multidrug-resistant_pathogen associated with DIS00severe_infections in hospitalized patients , including DIS00pneumonia , urinary and bloodstream DIS00infections .	multidrug-resistant_pathogen
The study objective was to investigate whether the strain of BAC00L0_monocytogenes serotype 1/2c isolated from DIS00neonatal_listeriosis carries a premature_stop codon ( PMSC ) mutation in the inlA gene .	isolate
BACKGROUND : Several_recent_small_studies have suggested a causal_link between Lyme DIS00disease and DIS00dilated_cardiomyopathy ( DIS00DCM ) by demonstrating the presence of the BAC00Borrelia_burgdorferi ( Bb ) genome in the myocardium of patients with DIS00recent-onset_DCM .	None
BAC00C0_trachomatis isolates that cause DIS00trachoma , sexually transmitted DIS00genital_tract_infections ( DIS00chlamydia ) and DIS00invasive_lymphogranuloma_venereum ( DIS00LGV ) , and the murine_strain BAC00C0_muridarum share 99 % of their gene content .	cause
These findings reveal adaptations of BAC00Y0_pestis to the dermis and how these adaptations can define the progression of DIS00disease .	progression
These results demonstrate a limited_role for IL-17 signaling through IL-17RA in the development of DIS00disease following DIS00infection of C3H mice with BAC00B0_burgdorferi .	with
UNASSIGNED : BAC00Vibrio_cholerae is a genetically diverse_species , and pathogenic_strains can encode different_virulence factors that mediate colonization and DIS00secretory_diarrhea .	encode
UNASSIGNED : Obligate BAC00intracellular_bacterium , BAC00Chlamydia_pneumoniae is not only a causative_agent of DIS00community-acquired_pneumonia , but is also associated with a more DIS00serious_chronic_disease , DIS00asthma , which might be exacerbated by air pollution containing carbon nanoparticles .	causative_agent
When exposed to germinants such as bile salts , BAC00C0_difficile spores return to life through germination in the gastrointestinal_tract and cause DIS00disease , but their germination has only been studied with population-wide_measurements .	cause
DIS00Immune_deficiencies caused by HIV give rise to numerous_opportunistic_gastrointestinal_pathogens such as BAC00Helicobacter_pylori , the commonest cause of DIS00chronic_gastritis .	numerous_opportunistic_gastrointestinal_pathogens
BACKGROUND : BAC00Streptococcus_equi subspecies zooepidemicus ( BAC00Streptococcus zooepidemicus ) is a rare_cause of DIS00meningitis in humans .	rare_cause
In this study , we characterized in vivo DNA binding and gene regulation by the cAMP-responsive_protein CRP in BAC00M0_bovis_BCG as a model for DIS00tuberculosis ( DIS00TB ) - complex_bacteria .	model
UNASSIGNED : DIS00Urinary_tract_infections caused by BAC00uropathogenic_E0_coli are among the most DIS00prevalent_infectious_diseases .	cause
UNASSIGNED : DIS00Leprosy is a DIS00chronic_granulomatous_infection caused by the organism BAC00Mycobacterium_leprae that primarily affects the skin and peripheral_nerves .	cause
UNASSIGNED : The present_study aimed at investigating the DIS00potential_anti_colon_cancer activity of three purified exopolysaccharides fractions ( LHEPS-1 , LHEPS-2 and LHEPS-3 ) from the BAC00Lactobacillus_helveticus MB2-1 .	None
The goal of the study was to evaluate detection of poly-y-D-glutamic_acid ( PGA ) , the capsular_antigen of BAC00B0_anthracis , as a biomarker surrogate for blood culture in a rabbit model of DIS00inhalational_anthrax .	None
BACKGROUND : BAC00Streptococcus_pneumoniae is one major_cause of DIS00pneumonia in human and contains various_virulence factors that contribute to pathogenesis of DIS00pneumococcal_disease .	major_cause
OBJECTIVE : To investigate the effect of BAC00Helicobacter_pylori ( BAC00H0_pylori ) eradication on the expression level of the FHIT gene and its methylation status in the gastric_mucosa_of_dyspeptic_patients with or without a family history of DIS00gastric_cancer ( FHGC ) .	None
BAC00Anaplasma_marginale is an economically important_tick-borne_pathogen of cattle that causes DIS00bovine_anaplasmosis .	cause
The potentials of BAC00Mycobacterium_leprae 65-kD_heat-shock protein or Toll-like_receptor 9 ligand ( CpG oligodeoxynucleotides ) as immune_modulators for the treatment of DIS00airway_allergic_disease have been studied individually .	treatment
OBJECTIVES : BAC00Coxiella_burnetii is an BAC00obligate_intracellular_bacterium that is found worldwide , is associated or suggested to be associated with DIS00reproductive_abnormalities in a number of species including cats , and is the cause of DIS00Q_fever in humans .	associate
BAC00Legionella_pneumophila , the etiological_agent of DIS00legionellosis , replicates within phagocytic_cells .	etiological_agent
The DIS00syphilis spirochete BAC00Treponema_pallidum is an important_human_pathogen but a highly BAC00enigmatic_bacterium that can not be cultivated in vitro .	important_human_pathogen
IMPORTANCE : BAC00Treponema_pallidum , the DIS00syphilis spirochete , exploits its periplasmic_lipoproteins for a number of essential_physiologic_processes .	None
BAC00Enteropathogenic_Escherichia_coli ( EPEC ) uses a type III secretion system ( T3SS ) to directly translocate effector proteins into host cells where they play a pivotal_role in subverting host cell signaling needed for DIS00disease .	None
AIM : To evaluate the incidence and clinical_characteristics of DIS00gastric_cancer ( DIS00GC ) in DIS00peptic_ulcer patients with BAC00Helicobacter_pylori ( BAC00H0_pylori ) DIS00infection .	None
BAC00Streptococcus_pneumoniae serotype 1 is one of the leading causes of DIS00invasive_pneumococcal_disease .	cause
BAC00Mycobacterium_bovis is the major_causative_agent of DIS00bovine_tuberculosis , one of the most relevant_zoonoses in the world , and affects a wide_range of wild and domesticated_animals .	major_causative_agent
Virulence factors of BAC00Helicobacter_pylori can predict the development of DIS00different_gastroduodenal_diseases .	development
These findings suggest a mechanism for DIS00neutropenia in DIS00chronic_brucellosis and reveal a BAC00novel_Brucella - host cross-talk through which BAC00B0_abortus is able to hinder the innate_function of PMN .	None
BAC00Salmonella_enterica serovar Typhi ( S. Typhi ) is a foodborne_pathogen that causes DIS00typhoid_fever and DIS00infects only humans .	foodborne_pathogen, cause
BAC00Pasteurella_multocida is an important_pathogen in food-producing_animals and numerous_virulence genes have been identified in an attempt to elucidate the pathogenesis of DIS00pasteurellosis .	None
Two BAC00Nocardiopsis species , namely , BAC00N0_dassonvillei and BAC00N0_synnemataformans ( among the thirty nine reported ones ) are opportunistic_human_pathogens and cause DIS00mycetoma , DIS00suppurative_infections and abscesses .	opportunistic_human_pathogens
UNASSIGNED : BAC00Mycobacterium_bovis_bacillus Calmette-Gu rin ( BAC00M0_bovis_BCG ) , the only currently available_vaccine against DIS00tuberculosis , induces variable_protection in adults .	available_vaccine
BACKGROUND : Genotyping BAC00Mycobacterium_tuberculosis isolates allows study of dynamics of DIS00tuberculosis transmission , while geoprocessing allows spatial_analysis of clinical and epidemiological_data .	allow
BAC00Mycobacterium_tuberculosis isolates belonging to identical_RFLP patterns ( clusters ) were considered to represent DIS00recent_tuberculosis_infection ( cases ) .	represent
UNASSIGNED : BAC00Laribacter_hongkongensis is a potential emerging pathogen associated with community acquired DIS00gastroenteritis and traveler 's DIS00diarrhea .	associate
UNASSIGNED : BAC00Acinetobacter_baumannii is an emerging nosocomial_pathogen involved in a DIS00variety_of_infections ranging from DIS00minor_soft-tissue_infections to more DIS00severe_infections such as DIS00ventilator0associated_pneumonia and DIS00bacteremia .	nosocomial_pathogen, involve
In this study , we focus on the potential_role of the major_high-affinity_thrombin receptor , proteinase-activated_receptor 1 ( PAR-1 ) , during the development of DIS00pneumonia to the common_lung pathogen BAC00Streptococcus_pneumoniae .	pathogen
The distinction between the two species is extremely important given the different_antibiotic_susceptibility pattern and association of BAC00N0_pseudobrasiliensis with more invasive and disseminated DIS00disease .	association 
The aim of this investigation has been to examine the response of intestinal_epithelial_cells to BAC00Enterococcus_faecium NCIMB 10415 ( BAC00E0_faecium ) , a probiotic positively affecting DIS00diarrhea incidence in piglets , and two BAC00pathogenic_Escherichia_coli ( BAC00E0_coli ) strains , with specific_focus on the probiotic_modulation of the response to the pathogenic_challenge .	affect
BACKGROUND : Oral_therapy for DIS00pulmonary_tuberculosis ( DIS00TB ) treatment suffers from the limitation of hepatic_metabolism leading insufficient_concentration of antitubercular ( DIS00anti_TB ) drugs in alveolar_macrophage which harbors BAC00Mycobacterium_tuberculosis ( BAC00MTB ) .	None
The objective of this study was to determine the possibility of additional_case detection for DIS00pulmonary_tuberculosis ( DIS00PTB ) by offering Xpert to smear-negative_patients in a low-HIV burden setting with no BAC00Mycobacterium_tuberculosis ( M.tb . ) culture facilities .	None
The objective_premises of the definition of BAC00H0_pylori as a potential limiting factor for assessing the quality of drinking water have been validated as follows : BAC00H0_pylori is an etiologic_factor associated to the development of DIS00chronic_antral_gastritis , DIS00gastric_ulcer and DIS00duodenal_ulcer , and DIS00gastric_cancer either , in the Russian_population the rate of DIS00infection with BAC00H0_pylori falls within range of 56 - 90 % , water supply pathway now can be considered as a source of DIS00infection of the population with BAC00H0_pylori , the existence of WHO regulatory_documents considering BAC00H0_pylori as a candidate for standardization of the quality of the drinking water quite common_occurrence of biocorrosion , the reduction of sanitary_water network reliability , that creates the possibility of concentrating BAC00H0_pylori in some areas of the water system and its delivery to the consumer of drinking water , and causes the necessity of the prevention of BAC00H0_pylori - associated gastric_pathology of the population .	etiologic_factor, associate
Bearing in mind the large_economic_losses due to , on the one hand , the prevalence of DIS00disease caused by BAC00H0_pylori , and , on the other_hand , the biocorrosion of water supply system , the problem is both relevant in terms of communal_hygiene and economy .	cause
UNASSIGNED : Background The prevalence of DIS00drug-resistant_tuberculosis ( DIS00TB ) in Xinjiang is higher than in other_regions of China , and Beijing/W lineage BAC00Mycobacterium_tuberculosis ( BAC00MTB ) is the dominant_strain of DIS00MTB in Xinjiang .	dominant_strain
Although BAC00B0_cereus sensu lato levels in Korean_fermented_soybean products did not exceed the maximum levels permitted in South Korea ( < 10 ( 4 ) CFU/g ) , these results indicate that the bacterial_isolates have the potential to cause DIS00diarrheal_or_emetic_gastrointestinal_diseases .	cause
BAC00Cronobacter_sakazakii is an opportunistic_pathogen associated with outbreaks of DIS00life-threatening_necrotizing_enterocolitis , DIS00meningitis_and_sepsis in neonates and infants .	opportunistic_pathogen, associate
UNASSIGNED : BAC00Bacillus_anthracis , the causative_agent of DIS00anthrax , is considered a high-priority_agent that may be used in a food-related_terrorist_attack because it can be contracted by ingestion and it also forms spores with heat and chemical resistance .	causative_agent
UNASSIGNED : BAC00Cronobacter_sakazakii is an emerging pathogen that causes severe and life-threatening_conditions including DIS00meningitis , DIS00bacteremia , and DIS00necrotizing_enterocolitis .	pathogen, cause
Other_mycobacteria that may be present in raw_milk and may cause DIS00diseases are those belonging to the BAC00Mycobacterium_avium complex .	cause
UNASSIGNED : A 74-year-old_female_patient with DIS00end0stage_renal_disease , undergoing periodic_hemodialysis , was hospitalized due to DIS00infection by BAC00multidrug-resistant_Acinetobacter_baumannii after hip replacement surgery .	by
PURPOSE : Gastric_colonization with BAC00Helicobacter_pylori ( BAC00H0_pylori ) has been implicated in the pathogenesis of DIS00pancreatic_cancer , but results of epidemiological_studies have been inconclusive .	implicate
RESULTS : No overall_association was observed between BAC00H0_pylori seropositivity and risk of DIS00pancreatic_cancer ( OR 1.00 ; 95 % CI 0.74-1 .35 ) .	overall_association
Nonsignificantly decreased DIS00pancreatic_cancer risk was observed with CagA seropositivity ( OR 0.74 ; 95 % CI 0.48-1 .15 ) and increased risk with BAC00CagA-negative_H0_pylori seropositivity ( OR 1.23 ; 95 % CI 0.83-1 .82 ) .	None
There was no significant_overall_association between BAC00H0_pylori seropositivity and DIS00pancreatic_cancer risk ( OR 1.13 ; 95 % CI 0.86-1 .50 ) , but evidence of CagA strain-specific_associations ( OR 0.78 ; 95 % CI 0.67-0 .91 and OR 1.30 ; 95 % CI 1.02-1 .65 for CagA-positive and CagA-negative_strains , respectively ) .	significant_overall_association
CONCLUSIONS : Our results provide further_evidence for the existence of strain-specific_associations between BAC00H0_pylori and DIS00pancreatic_cancer .	strain-specific_associations
Most DIS00chronic_staphylococcal_infections in rabbits are caused by the ST121 lineage of BAC00Staphylococcus_aureus , although other less common_lineages , such as ST96 can also be involved .	cause
UNASSIGNED : Numerous_isolates of BAC00Flavobacterium_columnare were previously recovered from DIS00red_tilapia , Oreochromis sp. , exhibiting DIS00columnaris0like_disease in Thai farms , and the phenotypic and genetic_characteristics were described .	recover
It can be concluded from the present_study that tuberculin testing is a useful_method in studying the prevalence of DIS00disease as the PCR for BAC00Mycobacterium genus was positive in 92.5 % , BAC00M0_tuberculosis complex in 86.8 % and BAC00Mycobacterium_bovis in 77.4 % cases .	None
In this work , viruses such as hepatitis E virus , Japanese_encephalitis virus , Influenza virus and Nipah virus , and bacteria such as BAC00Salmonella spp. , Shiga BAC00toxin-producing_Escherichia_coli , BAC00Campylobacter spp . and BAC00Leptospira spp . have been identified as the most prone to be transmitted from wild_swine to humans on the basis of geographic_spread in wild_swine populations worldwide , pathogen circulation rates in wild_swine populations , wild_swine population trends in endemic_areas , susceptibility of humans to DIS00infection , transmissibility from wild_swine to humans and existing evidence of wild_swine-human transmission events .	None
Two of the patients , undergoing peripheral_blood allogeneic_hematopoietic_stem cell transplantation ( alloHSCT ) from human_leukocyte antigen-identical_sibling donors , died of DIS00pneumonia caused by BAC00C0_indologenes with or without BAC00Pseudomonas_aeruginosa .	cause
BAC00Group_B_streptococcus ( GBS ; BAC00Streptococcus_agalactiae ) are encapsulated gram-positive_cocci belonging to Lancefield group B , that frequently colonizes the human_genital and DIS00gastrointestinal_tracts .	None
Complex interplays between BAC00P0_aeruginosa and other_co-colonizing_pathogens including BAC00Staphylococcus_aureus , BAC00Burkholderia sp. , and BAC00Klebsiella_pneumoniae may be crucial for pathogenesis and DIS00disease progression .	crucial
Initially , BAC00L0_reuteri was used in humans to reduce the incidence and the severity of DIS00diarrhea , prevent colic and DIS00necrotic_enterocolitis , and maintain a functional_mucosal_barrier .	reduce
CONCLUSION : Analysis of recent_nationwide_studies revealed BAC00V0_cholerae was the most common_bacterial/parasitic_agent of DIS00diarrhea across all populations , being followed by DIS00diarrhea BAC00genic_E0_coli and DIS00Giardia_intestinalis .	common_bacterial/parasitic_agent
DIS00Presumptive_acute_brucellosis due to BAC00B0_abortus was identified among 26 ( 7.0 % ) of patients while BAC00B0_melitensis was detected in 57 ( 15.4 % ) of the enrolled patients .	due
The test-and-treat_strategy for detecting BAC00H0_pylori is appropriate in situations where the risk of DIS00gastric_cancer is low based on age younger than 55 years and the absence of alarm symptoms .	appropriate
UNASSIGNED : Arbutin induced suppression of DIS00angular_leaf_spot_disease in cucumber resulting from lower populations of BAC00Pseudomonas_syringae pv lachrymans in the infected_tissues .	result
METHODS : BAC00H0_pylori status was reviewed in 154 patients with DIS00celiac_disease or DIS00duodenal_intraepithelial_lymphocytosis and in a control population .	review
RESULTS : BAC00H0_pylori prevalence was 36 % in DIS00celiac_disease patients , 19 % in case of DIS00duodenal_intraepithelial_lymphocytosis and 41 % in controls ( P < 0.05 vs. DIS00duodenal_intraepithelial_lymphocytosis ) .	in
BAC00H0_pylori prevalence was not significantly different between DIS00celiac_disease patients with or without iron DIS00deficiency_anemia ( 22 % vs. 39 % ) and it was higher in patients with DIS00milder_duodenal_lesions : 50 % in Marsh-Oberhuber classification type 1-2 vs. 33 % in type 3 .	significantly, different
CONCLUSION : BAC00H0_pylori prevalence was similar in DIS00celiac_disease patients and in controls and higher in patients with DIS00milder_duodenal_lesions .	prevalence, similar
The presence of BAC00H0_pylori was examined in the surgical_specimens of 88 patients ( 41 females and 47 males ; age range 6-70 years , mean age 32.5 14.8 years ) , including 35 patients with TS , 22 patients with DIS00cholesteatoma , 20 patients with CSOM , and 11 patients with DIS00otosclerosis .	examine
Tympanosclerotic_plaques and control specimens from the DIS00cholesteatoma , polypoid mucosa , or mucosal_portion of the perforations and stapes supra structure were examined for the presence of BAC00H0_pylori and/or BAC00C0_pneumoniae using real-time_polymerase chain reaction analysis .	None
The BAC00enterohemorrhagic_Escherichia_coli_O1570H7 is a frequent and potent_foodborne_pathogen that causes DIS00severe_disease in humans .	potent_foodborne_pathogen, cause
BACKGROUND : BAC00Mycoplasma_pneumoniae ( BAC00M0_pneumoniae ) is an important_pathogen of DIS00community-acquired_pneumonia in children , but the epidemiology and clinical_features of DIS00M0_pneumoniae_infection in infants are reported in only a few_studies .	important_pathogen
Such_responses are important for the protection against DIS00diseases caused by intracellular_bacteria such as BAC00Chlamydia_trachomatis and BAC00Mycobacterium_tuberculosis .	cause
DIS00Canine_monocytic_ehrlichiosis ( CME ) , caused by BAC00Ehrlichia_canis , is a DIS00vector-borne_disease with a worldwide_distribution .	cause
UNASSIGNED : The main_goal of this study was to develop an improved oral_delivery system for BAC00Pediococcus_pentosaceus OZF , a BAC00promising_probiotic_bacterium , and to assess its viability under simulated_gastrointestinal ( DIS00GI ) tract model by comparing the efficiency of microbiological and molecular_approaches .	None
Based on the 10 years data ( 1992-2001 ) from China , DIS00gastroenteritis caused by BAC00Vibrio_parahaemolyticus accounted for 31.1 % of DIS00foodborne_disease outbreaks that were resulted from microorganisms .	cause
OBJECTIVE : The aim of this study was to express BAC00Mycobacterium_tuberculosis MPT83 protein and to evaluate its immunogenicity in murine_model as well as the serological_diagnosis potential_value for DIS00bovine_tuberculosis .	None
Our research objectives were to determine if ( 1 ) fin clips , gill snips , surface mucus scrapings , blood draws , or kidney biopsies could be obtained non-lethally from 3 to 15 g DIS00Chinook_salmon_Oncorhynchus_tshawytscha , ( 2 ) non-lethal_samples could accurately discriminate between fish exposed to the bacterial_kidney_disease agent BAC00Renibacterium_salmoninarum and non-exposed_fish , and ( 3 ) non-lethal_samples could serve as proxies for lethal_kidney samples to assess DIS00infection intensity .	agent
Given the high_levels of BAC00C0_burnetii exposure in marine_mammals distributed throughout the same_geographic_range as the northern_sea otter , and the presence of DIS00valvular_lesions seen in otters , the objective of this study was to determine the level of BAC00C0_burnetii exposure in otters and investigate any association between exposure , DIS00infection and DIS00valvular_disease in this species .	None
Ribosomal_RNA of BAC00Propionibacterium_acnes and BAC00P0_granulosum was measured by real-time_quantitative_reverse_transcription-polymerase chain reaction ( RT-PCR ) using formalin-fixed and paraffin-embedded_tissue of lymph node biopsy from 65 Chinese_patients with DIS00sarcoidosis , 45 with DIS00tuberculosis and 50 controls with DIS00other_diseases ( 23 with DIS00non-specific_lymphadenitis and 27 with mediastinal_lymph node metastasis from DIS00lung_cancer ) .	None
UNASSIGNED : DIS00Tuberculosis remains one of the world 's deadliest DIS00human_diseases , with a high_prevalence of BAC00antibiotic-resistant_Mycobacterium_tuberculosis ( BAC00Mtb ) strains .	high_prevalence
A DIS00murine_sporotrichosis model showed that a BAC00S0_brasiliensis strain with high_expression of virulence factors was able to disseminate and yield a high_fungal_burden in comparison with a control S. schenckii strain .	show
DIS00Tuberculosis ( DIS00TB ) is a DIS00chronic_infectious_disease , considered as the second leading cause of DIS00death worldwide , caused by BAC00Mycobacterium_tuberculosis .	cause
Distributions for model parameters ( e.g. , release quantity of BAC00B0_anthracis spores , risk of illness , spore setting velocity , resuspension rate , sample recovery efficiency , etc. ) were updated by comparing model predictions with measurements of BAC00B0_anthracis spores made after one of the 2001 DIS00anthrax letter attacks .	after
Although drugs are subjected to much more severe_testing and regulation procedures before reaching the market , they might contain exactly the same_active_ingredient as certain_agrochemicals , what is the case described in present_work , showing how a small_chemical compound might be used to control pathogenicity of Gram negative_bacteria BAC00Xylella_fastidiosa which devastates citrus plantations , as well as for control of , for example , DIS00meningitis in humans .	devastate
BAC00Diverse_Streptococcus species including BAC00Streptococcus_Pneumoniae , Sanguis , Gordonii , DIS00Mitis and Mutans cause life-threatening_conditions including DIS00pneumonia , DIS00bacteremia_and_meningitis .	cause
All together , these results underline the promising_scope of HM-based_macromolecular_ligands for the antiadhesive_treatment of BAC00E0_coli induced DIS00inflammatory_bowel_diseases .	induce
Much of the DIS00disease burden can be avoided by immunization , particularly against BAC00Haemophilus_influenzae type b ( Hib ) and BAC00Streptococcus_pneumoniae .	avoid
It was previously demonstrated that the administration of milk fermented by BAC00Lactobacillus_casei CRL 431 -LSB- fermented_milk ( FM ) -RSB- delayed the DIS00tumor growth in a DIS00murine_breast_cancer model .	delay
At present , BAC00Mycobacterium_bovis_Bacillus Calmette Guerin ( BCG ) is the singular_anti - TB vaccine available for the prevention of DIS00disease in humans ; however , this vaccine only provides limited_protection against DIS00Mycobacterium_tuberculosis_0Mtb0_infection .	vaccine, prevention
Employing a novel_medium designed to mimic the chemical composition of human_serum , we show here that BAC00Bacillus_anthracis , the causative_agent of DIS00anthrax_disease , proteolyzes human_hemoglobin to liberate essential_amino acids which enhance its growth .	causative_agent
Removing essential_amino acids from BSM revealed that two of the most abundant_proteins in blood - hemoglobin and serum albumin - can satiate the amino acid requirement for BAC00Bacillus_anthracis , the causative_agent of DIS00anthrax .	causative_agent
UNASSIGNED : BAC00Salmonella_enterica subspecies enterica serovar Typhimurium ( S. Typhimurium ) is one of the most prevalent_serovars in Europe - where both poultry and poultry related_products are common_sources of DIS00human_salmonellosis . Due to efficient_control programs , the prevalence of S. Typhimurium in Danish_poultry production is very low .	None
UNASSIGNED : BAC00Escherichia_coli of the O157 serogroup are comprised of a diverse_collection of more than 100 O157 : non-H7_serotypes that are found in the environment , animal reservoir , and infected_patients and some have been linked to severe_outbreaks of DIS00human_disease .	link
Among these , the BAC00enteropathogenic_E0_coli_O157 : non-H7_serotypes carry virulence factors that are hallmarks of BAC00enterohemorrhagic_E0_coli , such as causing attaching and effacing lesions during DIS00human_gastrointestinal_tract_infections .	cause
BACKGROUND : DIS00Typhoid_fever is an acute , invasive , and potentially DIS00fatal_systemic_infection caused by BAC00Salmonella_enterica subspecies enterica serotype Typhi ( S. Typhi ) .	cause
UNASSIGNED : BAC00Staphylococcus_aureus ( BAC00S0_aureus ) is an important_human_pathogen that causes DIS00several_diseases ranging from DIS00superficial_skin_infections to DIS00life-threatening_diseases .	important_human_pathogen, cause
UNASSIGNED : The leading risk factor for DIS00gastric_cancer in humans is DIS00infection by BAC00Helicobacter_pylori strains that express and translocate the oncoprotein CagA into host epithelial_cells .	by
BACKGROUND : DIS00Listeriosis , mostly caused by BAC00Listeria_monocytogenes species , has become a major_concern to public_health authorities due to its clinical_severity and high_mortality rate , particularly in high_risk groups .	cause
However , DIS00severe_sepsis can occur after TRUS prostate biopsies , with BAC00Escherichia_coli being the predominant_causative_agent .	predominant_causative_agent
METHODS : We compared BAC00E0_coli isolates from male_patients with DIS00bacteremic_urinary_tract_infection ( DIS00B0UTI ) to isolates of patients with post prostate biopsy DIS00sepsis ( PPBS ) , in terms of their sequence types , determined by multi-locus_sequence typing ( MLST ) and their virulence markers .	isolate
BAC00Staphylococcus_aureus that produce PVL are responsible for DIS00severe_diseases , including DIS00necrotizing_pneumonia .	responsible
SIGNIFICANCE AND IMPACT OF THE STUDY : Panton-Valentine leukocidin ( PVL ) is a pore-forming_toxin produced by BAC00Staphylococcus_aureus , responsible for neutrophil damage and key_player of DIS00severe_staphylococcal_diseases .	responsible
UNASSIGNED : The fluoroquinolone_moxifloxacin has potent_activity against BAC00Mycobacterium_tuberculosis and has been recommended by the guidelines for the treatment of DIS00pulmonary_tuberculosis ( DIS00TB ) .	None
UNASSIGNED : Between 2010 and 2014 , we obtained swab_specimens to detect BAC00Treponema_pallidum , with PCR assays , from the oral_cavities of 240 patients with 267 episodes of DIS00syphilis who reported engaging in unprotected_sex practices .	from
UNASSIGNED : BAC00Neisseria_meningitidis can cause severe and DIS00fulminant_diseases such as DIS00meningitis . DIS00Meningococcal_capsular_polysaccharide ( PS ) is a key_virulence determinant that is not able to induce immunological_memory .	cause
During an inflammatory_response in the gut , some commensal_bacteria such as BAC00E0_coli can thrive and contribute to DIS00disease .	contribute
These findings define a fundamental_mechanism by which BAC00E0_coli surpasses the host innate_immune_responses during inflammatory_gut DIS00diseases and gains a distinct_survival advantage .	innate_immune_responses
The BAC00V0_antiquarius genome encodes genes and operons with ecological_functions relevant to the environment conditions of the deep_sea and also harbors factors known to be involved in DIS00human_disease caused by freshwater , coastal , and brackish_water vibrios .	factor
BAC00Xanthomonas_albilineans causes leaf scald , a DIS00lethal_disease of sugarcane . Compared to other_species of BAC00Xanthomonas , BAC00X0_albilineans exhibits distinctive_pathogenic_mechanisms , ecology and taxonomy .	cause
BACKGROUND : BAC00Neisseria_lactamica as one of the main_commensal in oropharynx during the childhood is related to the induction of a natural_immunity against DIS00meningococcal_meningitis .	relate, against
FTIR analysis was performed to assess the chemical linkages , and antimicrobial_assays were performed with two strains : BAC00Staphylococcus_aureus ( BAC00Gram-positive_bacterium ) and DIS00Klebsiella_pneumonia ( DIS00Gram-negative_bacterium ) .	None
UNASSIGNED : The BAC00Bordetella_pertussis polymerase chain reaction positivity rate changed after DIS00additional_diphtheria0tetanus - DIS00acellular_pertussis boosters in 2005 and 2008 , 9.8 % , 13.4 % , 22 % and 15.2 % in 2010 , 2011 , 2012 and 2013 , P < 0.001 , respectively .	change
BAC00CagA-positive_H0_pylori is associated with an increased risk for DIS00gastric_cancer compared with negative_strains .	associate
The Lyme DIS00disease spirochete BAC00Borrelia_burgdorferi migrates to distant_sites in the tick vectors and mammalian_hosts through robust_motility and chemotaxis activities .	None
In this article , we studied how two proteins , called FliH and FliI , are important for the production of full-length_flagella in the Lyme DIS00disease spirochete BAC00Borrelia_burgdorferi .	None